ID,Length,AGG,CGG,GGG,TGG,NGG
"NC_037285.1 Populus trichocarpa isolate Nisqually-1 chromosome 1, Pop_tri_v3, whole genome shotgun sequence",50495391,415452,112199,205348,499952,1232951
"NC_037286.1 Populus trichocarpa isolate Nisqually-1 chromosome 2, Pop_tri_v3, whole genome shotgun sequence",25263035,212103,62436,107340,257628,639507
"NC_037287.1 Populus trichocarpa isolate Nisqually-1 chromosome 3, Pop_tri_v3, whole genome shotgun sequence",21816808,183756,50888,92352,225805,552801
"NC_037288.1 Populus trichocarpa isolate Nisqually-1 chromosome 4, Pop_tri_v3, whole genome shotgun sequence",24267051,196139,51868,95640,235325,578972
"NC_037289.1 Populus trichocarpa isolate Nisqually-1 chromosome 5, Pop_tri_v3, whole genome shotgun sequence",25890704,213946,60422,106919,259913,641200
"NC_037290.1 Populus trichocarpa isolate Nisqually-1 chromosome 6, Pop_tri_v3, whole genome shotgun sequence",27912125,229206,61222,112144,277626,680198
"NC_037291.1 Populus trichocarpa isolate Nisqually-1 chromosome 7, Pop_tri_v3, whole genome shotgun sequence",15610913,126490,32823,61582,150778,371673
"NC_037292.1 Populus trichocarpa isolate Nisqually-1 chromosome 8, Pop_tri_v3, whole genome shotgun sequence",19465461,173539,53526,90217,211823,529105
"NC_037293.1 Populus trichocarpa isolate Nisqually-1 chromosome 9, Pop_tri_v3, whole genome shotgun sequence",12948742,115087,32865,57900,141379,347231
"NC_037294.1 Populus trichocarpa isolate Nisqually-1 chromosome 10, Pop_tri_v3, whole genome shotgun sequence",22580532,194780,57681,98571,235383,586415
"NC_037295.1 Populus trichocarpa isolate Nisqually-1 chromosome 11, Pop_tri_v3, whole genome shotgun sequence",18501271,147566,38260,71119,177271,434216
"NC_037296.1 Populus trichocarpa isolate Nisqually-1 chromosome 12, Pop_tri_v3, whole genome shotgun sequence",15760346,127506,33340,62491,153560,376897
"NC_037297.1 Populus trichocarpa isolate Nisqually-1 chromosome 13, Pop_tri_v3, whole genome shotgun sequence",16320717,131734,33593,63961,158500,387788
"NC_037298.1 Populus trichocarpa isolate Nisqually-1 chromosome 14, Pop_tri_v3, whole genome shotgun sequence",18920894,160168,47572,81537,193808,483085
"NC_037299.1 Populus trichocarpa isolate Nisqually-1 chromosome 15, Pop_tri_v3, whole genome shotgun sequence",15278577,125417,32758,61467,151370,371012
"NC_037300.1 Populus trichocarpa isolate Nisqually-1 chromosome 16, Pop_tri_v3, whole genome shotgun sequence",14494361,116787,31921,57376,141005,347089
"NC_037301.1 Populus trichocarpa isolate Nisqually-1 chromosome 17, Pop_tri_v3, whole genome shotgun sequence",16080358,129183,34705,63230,154083,381201
"NC_037302.1 Populus trichocarpa isolate Nisqually-1 chromosome 18, Pop_tri_v3, whole genome shotgun sequence",16958300,134059,35052,65426,160715,395252
"NC_037303.1 Populus trichocarpa isolate Nisqually-1 chromosome 19, Pop_tri_v3, whole genome shotgun sequence",15942145,121468,33186,60509,145756,360919
"NW_020167869.1 Populus trichocarpa isolate Nisqually-1 unplaced genomic scaffold, Pop_tri_v3 scaffold_20, whole genome shotgun sequence",948134,6968,2323,3613,8531,21435
"NW_020167870.1 Populus trichocarpa isolate Nisqually-1 unplaced genomic scaffold, Pop_tri_v3 scaffold_21, whole genome shotgun sequence",931759,4211,1598,2170,4130,12109
"NW_020167871.1 Populus trichocarpa isolate Nisqually-1 unplaced genomic scaffold, Pop_tri_v3 scaffold_22, whole genome shotgun sequence",1028913,3471,1531,1992,3674,10668
"NW_020167872.1 Populus trichocarpa isolate Nisqually-1 unplaced genomic scaffold, Pop_tri_v3 scaffold_23, whole genome shotgun sequence",832320,3616,936,1979,4125,10656
"NW_020167873.1 Populus trichocarpa isolate Nisqually-1 unplaced genomic scaffold, Pop_tri_v3 scaffold_24, whole genome shotgun sequence",673401,4783,1591,2289,5914,14577
"NW_020167874.1 Populus trichocarpa isolate Nisqually-1 unplaced genomic scaffold, Pop_tri_v3 scaffold_25, whole genome shotgun sequence",565605,4847,1253,2147,5836,14083
"NW_020167875.1 Populus trichocarpa isolate Nisqually-1 unplaced genomic scaffold, Pop_tri_v3 scaffold_26, whole genome shotgun sequence",561009,2328,555,1129,2335,6347
"NW_020167876.1 Populus trichocarpa isolate Nisqually-1 unplaced genomic scaffold, Pop_tri_v3 scaffold_27, whole genome shotgun sequence",548416,3167,930,1622,4019,9738
"NW_020167877.1 Populus trichocarpa isolate Nisqually-1 unplaced genomic scaffold, Pop_tri_v3 scaffold_28, whole genome shotgun sequence",512759,2260,482,1137,2469,6348
"NW_020167878.1 Populus trichocarpa isolate Nisqually-1 unplaced genomic scaffold, Pop_tri_v3 scaffold_29, whole genome shotgun sequence",527496,3996,1123,1908,4775,11802
"NW_020167879.1 Populus trichocarpa isolate Nisqually-1 unplaced genomic scaffold, Pop_tri_v3 scaffold_30, whole genome shotgun sequence",484195,4162,1065,2259,5480,12966
"NW_020167880.1 Populus trichocarpa isolate Nisqually-1 unplaced genomic scaffold, Pop_tri_v3 scaffold_31, whole genome shotgun sequence",440175,2846,1056,1401,3087,8390
"NW_020167881.1 Populus trichocarpa isolate Nisqually-1 unplaced genomic scaffold, Pop_tri_v3 scaffold_32, whole genome shotgun sequence",462213,3307,1185,1776,3811,10079
"NW_020167882.1 Populus trichocarpa isolate Nisqually-1 unplaced genomic scaffold, Pop_tri_v3 scaffold_33, whole genome shotgun sequence",442200,2115,720,1182,2116,6133
"NW_020167883.1 Populus trichocarpa isolate Nisqually-1 unplaced genomic scaffold, Pop_tri_v3 scaffold_34, whole genome shotgun sequence",446712,2591,1037,1357,3328,8313
"NW_020167884.1 Populus trichocarpa isolate Nisqually-1 unplaced genomic scaffold, Pop_tri_v3 scaffold_35, whole genome shotgun sequence",433784,2425,587,1210,2771,6993
"NW_020167885.1 Populus trichocarpa isolate Nisqually-1 unplaced genomic scaffold, Pop_tri_v3 scaffold_36, whole genome shotgun sequence",368085,2616,675,1328,3088,7707
"NW_020167886.1 Populus trichocarpa isolate Nisqually-1 unplaced genomic scaffold, Pop_tri_v3 scaffold_37, whole genome shotgun sequence",420783,2757,1146,1517,3347,8767
"NW_020167887.1 Populus trichocarpa isolate Nisqually-1 unplaced genomic scaffold, Pop_tri_v3 scaffold_38, whole genome shotgun sequence",361808,3041,1005,1634,3834,9514
"NW_020167888.1 Populus trichocarpa isolate Nisqually-1 unplaced genomic scaffold, Pop_tri_v3 scaffold_39, whole genome shotgun sequence",362833,2764,820,1416,3164,8164
"NW_020167889.1 Populus trichocarpa isolate Nisqually-1 unplaced genomic scaffold, Pop_tri_v3 scaffold_41, whole genome shotgun sequence",316090,2103,548,1039,2398,6088
"NW_020167890.1 Populus trichocarpa isolate Nisqually-1 unplaced genomic scaffold, Pop_tri_v3 scaffold_42, whole genome shotgun sequence",309264,2929,675,1428,3263,8295
"NW_020167891.1 Populus trichocarpa isolate Nisqually-1 unplaced genomic scaffold, Pop_tri_v3 scaffold_45, whole genome shotgun sequence",292166,3660,1414,2408,3605,11087
"NW_020167892.1 Populus trichocarpa isolate Nisqually-1 unplaced genomic scaffold, Pop_tri_v3 scaffold_47, whole genome shotgun sequence",268098,2131,722,1084,2956,6893
"NW_020167893.1 Populus trichocarpa isolate Nisqually-1 unplaced genomic scaffold, Pop_tri_v3 scaffold_48, whole genome shotgun sequence",268012,2058,633,941,2431,6063
"NW_020167894.1 Populus trichocarpa isolate Nisqually-1 unplaced genomic scaffold, Pop_tri_v3 scaffold_49, whole genome shotgun sequence",269156,2158,696,1046,2442,6342
"NW_020167895.1 Populus trichocarpa isolate Nisqually-1 unplaced genomic scaffold, Pop_tri_v3 scaffold_50, whole genome shotgun sequence",254906,1887,533,887,2088,5395
"NW_020167896.1 Populus trichocarpa isolate Nisqually-1 unplaced genomic scaffold, Pop_tri_v3 scaffold_51, whole genome shotgun sequence",250399,1576,477,799,1682,4534
"NW_020167897.1 Populus trichocarpa isolate Nisqually-1 unplaced genomic scaffold, Pop_tri_v3 scaffold_52, whole genome shotgun sequence",277164,910,214,465,828,2417
"NW_020167898.1 Populus trichocarpa isolate Nisqually-1 unplaced genomic scaffold, Pop_tri_v3 scaffold_53, whole genome shotgun sequence",257254,1676,353,792,1907,4728
"NW_020167899.1 Populus trichocarpa isolate Nisqually-1 unplaced genomic scaffold, Pop_tri_v3 scaffold_56, whole genome shotgun sequence",203981,976,290,453,959,2678
"NW_020167900.1 Populus trichocarpa isolate Nisqually-1 unplaced genomic scaffold, Pop_tri_v3 scaffold_57, whole genome shotgun sequence",337365,253,99,228,279,859
"NW_020167901.1 Populus trichocarpa isolate Nisqually-1 unplaced genomic scaffold, Pop_tri_v3 scaffold_61, whole genome shotgun sequence",192272,1776,517,881,2328,5502
"NW_020167902.1 Populus trichocarpa isolate Nisqually-1 unplaced genomic scaffold, Pop_tri_v3 scaffold_63, whole genome shotgun sequence",189656,1465,592,835,1297,4189
"NW_020167903.1 Populus trichocarpa isolate Nisqually-1 unplaced genomic scaffold, Pop_tri_v3 scaffold_64, whole genome shotgun sequence",178666,891,290,474,921,2576
"NW_020167904.1 Populus trichocarpa isolate Nisqually-1 unplaced genomic scaffold, Pop_tri_v3 scaffold_65, whole genome shotgun sequence",176155,1028,216,500,1206,2950
"NW_020167905.1 Populus trichocarpa isolate Nisqually-1 unplaced genomic scaffold, Pop_tri_v3 scaffold_66, whole genome shotgun sequence",191790,1277,289,614,1589,3769
"NW_020167906.1 Populus trichocarpa isolate Nisqually-1 unplaced genomic scaffold, Pop_tri_v3 scaffold_67, whole genome shotgun sequence",178861,1599,468,736,1953,4756
"NW_020167907.1 Populus trichocarpa isolate Nisqually-1 unplaced genomic scaffold, Pop_tri_v3 scaffold_68, whole genome shotgun sequence",193879,1379,378,736,1778,4271
"NW_020167908.1 Populus trichocarpa isolate Nisqually-1 unplaced genomic scaffold, Pop_tri_v3 scaffold_69, whole genome shotgun sequence",214156,893,166,441,927,2427
"NW_020167909.1 Populus trichocarpa isolate Nisqually-1 unplaced genomic scaffold, Pop_tri_v3 scaffold_71, whole genome shotgun sequence",233060,653,198,345,811,2007
"NW_020167910.1 Populus trichocarpa isolate Nisqually-1 unplaced genomic scaffold, Pop_tri_v3 scaffold_73, whole genome shotgun sequence",173458,1303,562,684,1747,4296
"NW_020167911.1 Populus trichocarpa isolate Nisqually-1 unplaced genomic scaffold, Pop_tri_v3 scaffold_74, whole genome shotgun sequence",181841,681,285,300,538,1804
"NW_020167912.1 Populus trichocarpa isolate Nisqually-1 unplaced genomic scaffold, Pop_tri_v3 scaffold_75, whole genome shotgun sequence",174795,1161,286,594,1540,3581
"NW_020167913.1 Populus trichocarpa isolate Nisqually-1 unplaced genomic scaffold, Pop_tri_v3 scaffold_76, whole genome shotgun sequence",177420,1244,296,594,1335,3469
"NW_020167914.1 Populus trichocarpa isolate Nisqually-1 unplaced genomic scaffold, Pop_tri_v3 scaffold_77, whole genome shotgun sequence",199143,876,313,469,1081,2739
"NW_020167915.1 Populus trichocarpa isolate Nisqually-1 unplaced genomic scaffold, Pop_tri_v3 scaffold_78, whole genome shotgun sequence",165733,1165,446,610,1317,3538
"NW_020167916.1 Populus trichocarpa isolate Nisqually-1 unplaced genomic scaffold, Pop_tri_v3 scaffold_79, whole genome shotgun sequence",152131,1061,315,509,1315,3200
"NW_020167917.1 Populus trichocarpa isolate Nisqually-1 unplaced genomic scaffold, Pop_tri_v3 scaffold_80, whole genome shotgun sequence",153523,1158,299,530,1337,3324
"NW_020167918.1 Populus trichocarpa isolate Nisqually-1 unplaced genomic scaffold, Pop_tri_v3 scaffold_81, whole genome shotgun sequence",145664,810,210,441,901,2362
"NW_020167919.1 Populus trichocarpa isolate Nisqually-1 unplaced genomic scaffold, Pop_tri_v3 scaffold_82, whole genome shotgun sequence",146869,1296,328,647,1614,3885
"NW_020167920.1 Populus trichocarpa isolate Nisqually-1 unplaced genomic scaffold, Pop_tri_v3 scaffold_85, whole genome shotgun sequence",140956,1051,369,517,1325,3262
"NW_020167921.1 Populus trichocarpa isolate Nisqually-1 unplaced genomic scaffold, Pop_tri_v3 scaffold_86, whole genome shotgun sequence",151614,1138,283,498,1319,3238
"NW_020167922.1 Populus trichocarpa isolate Nisqually-1 unplaced genomic scaffold, Pop_tri_v3 scaffold_87, whole genome shotgun sequence",138717,960,324,482,1086,2852
"NW_020167923.1 Populus trichocarpa isolate Nisqually-1 unplaced genomic scaffold, Pop_tri_v3 scaffold_90, whole genome shotgun sequence",163129,964,211,523,1044,2742
"NW_020167924.1 Populus trichocarpa isolate Nisqually-1 unplaced genomic scaffold, Pop_tri_v3 scaffold_92, whole genome shotgun sequence",132020,938,326,440,1191,2895
"NW_020167925.1 Populus trichocarpa isolate Nisqually-1 unplaced genomic scaffold, Pop_tri_v3 scaffold_93, whole genome shotgun sequence",128341,1020,239,455,1112,2826
"NW_020167926.1 Populus trichocarpa isolate Nisqually-1 unplaced genomic scaffold, Pop_tri_v3 scaffold_94, whole genome shotgun sequence",129782,954,266,466,1123,2809
"NW_020167927.1 Populus trichocarpa isolate Nisqually-1 unplaced genomic scaffold, Pop_tri_v3 scaffold_95, whole genome shotgun sequence",138563,1326,337,609,1560,3832
"NW_020167928.1 Populus trichocarpa isolate Nisqually-1 unplaced genomic scaffold, Pop_tri_v3 scaffold_96, whole genome shotgun sequence",213988,124,81,179,188,572
"NW_020167929.1 Populus trichocarpa isolate Nisqually-1 unplaced genomic scaffold, Pop_tri_v3 scaffold_99, whole genome shotgun sequence",126454,970,240,380,978,2568
"NW_020167930.1 Populus trichocarpa isolate Nisqually-1 unplaced genomic scaffold, Pop_tri_v3 scaffold_102, whole genome shotgun sequence",119245,924,302,393,1106,2725
"NW_020167931.1 Populus trichocarpa isolate Nisqually-1 unplaced genomic scaffold, Pop_tri_v3 scaffold_104, whole genome shotgun sequence",146719,878,244,480,986,2588
"NW_020167932.1 Populus trichocarpa isolate Nisqually-1 unplaced genomic scaffold, Pop_tri_v3 scaffold_107, whole genome shotgun sequence",115315,736,224,375,783,2118
"NW_020167933.1 Populus trichocarpa isolate Nisqually-1 unplaced genomic scaffold, Pop_tri_v3 scaffold_109, whole genome shotgun sequence",109243,974,268,475,1091,2808
"NW_020167934.1 Populus trichocarpa isolate Nisqually-1 unplaced genomic scaffold, Pop_tri_v3 scaffold_111, whole genome shotgun sequence",118530,388,144,208,448,1188
"NW_020167935.1 Populus trichocarpa isolate Nisqually-1 unplaced genomic scaffold, Pop_tri_v3 scaffold_112, whole genome shotgun sequence",116414,853,296,414,1053,2616
"NW_020167936.1 Populus trichocarpa isolate Nisqually-1 unplaced genomic scaffold, Pop_tri_v3 scaffold_114, whole genome shotgun sequence",101143,632,285,354,708,1979
"NW_020167937.1 Populus trichocarpa isolate Nisqually-1 unplaced genomic scaffold, Pop_tri_v3 scaffold_116, whole genome shotgun sequence",103364,744,247,387,892,2270
"NW_020167938.1 Populus trichocarpa isolate Nisqually-1 unplaced genomic scaffold, Pop_tri_v3 scaffold_119, whole genome shotgun sequence",98608,716,215,321,941,2193
"NW_020167939.1 Populus trichocarpa isolate Nisqually-1 unplaced genomic scaffold, Pop_tri_v3 scaffold_121, whole genome shotgun sequence",132310,187,71,113,157,528
"NW_020167940.1 Populus trichocarpa isolate Nisqually-1 unplaced genomic scaffold, Pop_tri_v3 scaffold_122, whole genome shotgun sequence",97254,790,159,419,1075,2443
"NW_020167941.1 Populus trichocarpa isolate Nisqually-1 unplaced genomic scaffold, Pop_tri_v3 scaffold_123, whole genome shotgun sequence",95485,527,200,290,666,1683
"NW_020167942.1 Populus trichocarpa isolate Nisqually-1 unplaced genomic scaffold, Pop_tri_v3 scaffold_124, whole genome shotgun sequence",95924,316,95,173,417,1001
"NW_020167943.1 Populus trichocarpa isolate Nisqually-1 unplaced genomic scaffold, Pop_tri_v3 scaffold_126, whole genome shotgun sequence",98168,752,212,416,970,2350
"NW_020167944.1 Populus trichocarpa isolate Nisqually-1 unplaced genomic scaffold, Pop_tri_v3 scaffold_127, whole genome shotgun sequence",109858,671,222,378,913,2184
"NW_020167945.1 Populus trichocarpa isolate Nisqually-1 unplaced genomic scaffold, Pop_tri_v3 scaffold_128, whole genome shotgun sequence",99216,772,287,453,1109,2621
"NW_020167946.1 Populus trichocarpa isolate Nisqually-1 unplaced genomic scaffold, Pop_tri_v3 scaffold_131, whole genome shotgun sequence",95303,428,151,249,463,1291
"NW_020167947.1 Populus trichocarpa isolate Nisqually-1 unplaced genomic scaffold, Pop_tri_v3 scaffold_134, whole genome shotgun sequence",91263,583,228,311,648,1770
"NW_020167948.1 Populus trichocarpa isolate Nisqually-1 unplaced genomic scaffold, Pop_tri_v3 scaffold_135, whole genome shotgun sequence",94190,648,139,350,795,1932
"NW_020167949.1 Populus trichocarpa isolate Nisqually-1 unplaced genomic scaffold, Pop_tri_v3 scaffold_136, whole genome shotgun sequence",89170,818,212,417,1081,2528
"NW_020167950.1 Populus trichocarpa isolate Nisqually-1 unplaced genomic scaffold, Pop_tri_v3 scaffold_139, whole genome shotgun sequence",111518,753,192,394,930,2269
"NW_020167951.1 Populus trichocarpa isolate Nisqually-1 unplaced genomic scaffold, Pop_tri_v3 scaffold_141, whole genome shotgun sequence",115850,670,185,353,902,2110
"NW_020167952.1 Populus trichocarpa isolate Nisqually-1 unplaced genomic scaffold, Pop_tri_v3 scaffold_143, whole genome shotgun sequence",86785,586,268,333,740,1927
"NW_020167953.1 Populus trichocarpa isolate Nisqually-1 unplaced genomic scaffold, Pop_tri_v3 scaffold_145, whole genome shotgun sequence",90001,611,187,291,716,1805
"NW_020167954.1 Populus trichocarpa isolate Nisqually-1 unplaced genomic scaffold, Pop_tri_v3 scaffold_146, whole genome shotgun sequence",91718,831,290,439,974,2534
"NW_020167955.1 Populus trichocarpa isolate Nisqually-1 unplaced genomic scaffold, Pop_tri_v3 scaffold_148, whole genome shotgun sequence",89745,630,160,281,810,1881
"NW_020167956.1 Populus trichocarpa isolate Nisqually-1 unplaced genomic scaffold, Pop_tri_v3 scaffold_149, whole genome shotgun sequence",87786,628,280,370,951,2229
"NW_020167957.1 Populus trichocarpa isolate Nisqually-1 unplaced genomic scaffold, Pop_tri_v3 scaffold_150, whole genome shotgun sequence",90931,752,182,352,885,2171
"NW_020167958.1 Populus trichocarpa isolate Nisqually-1 unplaced genomic scaffold, Pop_tri_v3 scaffold_151, whole genome shotgun sequence",96257,703,238,412,870,2223
"NW_020167959.1 Populus trichocarpa isolate Nisqually-1 unplaced genomic scaffold, Pop_tri_v3 scaffold_156, whole genome shotgun sequence",82369,780,186,362,902,2230
"NW_020167960.1 Populus trichocarpa isolate Nisqually-1 unplaced genomic scaffold, Pop_tri_v3 scaffold_158, whole genome shotgun sequence",78621,697,212,416,862,2187
"NW_020167961.1 Populus trichocarpa isolate Nisqually-1 unplaced genomic scaffold, Pop_tri_v3 scaffold_162, whole genome shotgun sequence",77872,686,175,320,823,2004
"NW_020167962.1 Populus trichocarpa isolate Nisqually-1 unplaced genomic scaffold, Pop_tri_v3 scaffold_165, whole genome shotgun sequence",89862,34,22,20,38,114
"NW_020167963.1 Populus trichocarpa isolate Nisqually-1 unplaced genomic scaffold, Pop_tri_v3 scaffold_168, whole genome shotgun sequence",159013,659,239,321,865,2084
"NW_020167964.1 Populus trichocarpa isolate Nisqually-1 unplaced genomic scaffold, Pop_tri_v3 scaffold_169, whole genome shotgun sequence",79356,614,172,277,756,1819
"NW_020167965.1 Populus trichocarpa isolate Nisqually-1 unplaced genomic scaffold, Pop_tri_v3 scaffold_170, whole genome shotgun sequence",76965,544,213,286,794,1837
"NW_020167966.1 Populus trichocarpa isolate Nisqually-1 unplaced genomic scaffold, Pop_tri_v3 scaffold_172, whole genome shotgun sequence",83343,460,152,243,542,1397
"NW_020167967.1 Populus trichocarpa isolate Nisqually-1 unplaced genomic scaffold, Pop_tri_v3 scaffold_174, whole genome shotgun sequence",79445,589,178,313,778,1858
"NW_020167968.1 Populus trichocarpa isolate Nisqually-1 unplaced genomic scaffold, Pop_tri_v3 scaffold_175, whole genome shotgun sequence",75316,459,182,250,581,1472
"NW_020167969.1 Populus trichocarpa isolate Nisqually-1 unplaced genomic scaffold, Pop_tri_v3 scaffold_178, whole genome shotgun sequence",73362,509,178,251,553,1491
"NW_020167970.1 Populus trichocarpa isolate Nisqually-1 unplaced genomic scaffold, Pop_tri_v3 scaffold_179, whole genome shotgun sequence",93335,550,189,285,672,1696
"NW_020167971.1 Populus trichocarpa isolate Nisqually-1 unplaced genomic scaffold, Pop_tri_v3 scaffold_181, whole genome shotgun sequence",79822,489,104,252,554,1399
"NW_020167972.1 Populus trichocarpa isolate Nisqually-1 unplaced genomic scaffold, Pop_tri_v3 scaffold_183, whole genome shotgun sequence",79289,481,175,274,673,1603
"NW_020167973.1 Populus trichocarpa isolate Nisqually-1 unplaced genomic scaffold, Pop_tri_v3 scaffold_184, whole genome shotgun sequence",71656,583,168,262,688,1701
"NW_020167974.1 Populus trichocarpa isolate Nisqually-1 unplaced genomic scaffold, Pop_tri_v3 scaffold_185, whole genome shotgun sequence",88296,733,285,319,676,2013
"NW_020167975.1 Populus trichocarpa isolate Nisqually-1 unplaced genomic scaffold, Pop_tri_v3 scaffold_186, whole genome shotgun sequence",73657,625,181,340,834,1980
"NW_020167976.1 Populus trichocarpa isolate Nisqually-1 unplaced genomic scaffold, Pop_tri_v3 scaffold_188, whole genome shotgun sequence",76394,446,188,272,647,1553
"NW_020167977.1 Populus trichocarpa isolate Nisqually-1 unplaced genomic scaffold, Pop_tri_v3 scaffold_190, whole genome shotgun sequence",70225,670,202,344,874,2090
"NW_020167978.1 Populus trichocarpa isolate Nisqually-1 unplaced genomic scaffold, Pop_tri_v3 scaffold_194, whole genome shotgun sequence",73978,494,167,277,615,1553
"NW_020167979.1 Populus trichocarpa isolate Nisqually-1 unplaced genomic scaffold, Pop_tri_v3 scaffold_197, whole genome shotgun sequence",78475,545,138,288,707,1678
"NW_020167980.1 Populus trichocarpa isolate Nisqually-1 unplaced genomic scaffold, Pop_tri_v3 scaffold_200, whole genome shotgun sequence",89828,508,181,284,639,1612
"NW_020167981.1 Populus trichocarpa isolate Nisqually-1 unplaced genomic scaffold, Pop_tri_v3 scaffold_201, whole genome shotgun sequence",89276,539,160,263,606,1568
"NW_020167982.1 Populus trichocarpa isolate Nisqually-1 unplaced genomic scaffold, Pop_tri_v3 scaffold_204, whole genome shotgun sequence",92486,539,197,249,533,1518
"NW_020167983.1 Populus trichocarpa isolate Nisqually-1 unplaced genomic scaffold, Pop_tri_v3 scaffold_205, whole genome shotgun sequence",67985,492,126,245,539,1402
"NW_020167984.1 Populus trichocarpa isolate Nisqually-1 unplaced genomic scaffold, Pop_tri_v3 scaffold_207, whole genome shotgun sequence",68427,713,208,351,814,2086
"NW_020167985.1 Populus trichocarpa isolate Nisqually-1 unplaced genomic scaffold, Pop_tri_v3 scaffold_213, whole genome shotgun sequence",68587,679,230,331,859,2099
"NW_020167986.1 Populus trichocarpa isolate Nisqually-1 unplaced genomic scaffold, Pop_tri_v3 scaffold_217, whole genome shotgun sequence",71516,159,64,63,114,400
"NW_020167987.1 Populus trichocarpa isolate Nisqually-1 unplaced genomic scaffold, Pop_tri_v3 scaffold_218, whole genome shotgun sequence",65017,597,239,314,635,1785
"NW_020167988.1 Populus trichocarpa isolate Nisqually-1 unplaced genomic scaffold, Pop_tri_v3 scaffold_219, whole genome shotgun sequence",69799,529,141,271,666,1607
"NW_020167989.1 Populus trichocarpa isolate Nisqually-1 unplaced genomic scaffold, Pop_tri_v3 scaffold_220, whole genome shotgun sequence",102812,98,30,39,99,266
"NW_020167990.1 Populus trichocarpa isolate Nisqually-1 unplaced genomic scaffold, Pop_tri_v3 scaffold_221, whole genome shotgun sequence",65566,613,115,282,626,1636
"NW_020167991.1 Populus trichocarpa isolate Nisqually-1 unplaced genomic scaffold, Pop_tri_v3 scaffold_222, whole genome shotgun sequence",67768,591,163,279,620,1653
"NW_020167992.1 Populus trichocarpa isolate Nisqually-1 unplaced genomic scaffold, Pop_tri_v3 scaffold_223, whole genome shotgun sequence",63517,442,121,234,539,1336
"NW_020167993.1 Populus trichocarpa isolate Nisqually-1 unplaced genomic scaffold, Pop_tri_v3 scaffold_224, whole genome shotgun sequence",157500,124,34,75,107,340
"NW_020167994.1 Populus trichocarpa isolate Nisqually-1 unplaced genomic scaffold, Pop_tri_v3 scaffold_226, whole genome shotgun sequence",61995,499,162,258,630,1549
"NW_020167995.1 Populus trichocarpa isolate Nisqually-1 unplaced genomic scaffold, Pop_tri_v3 scaffold_229, whole genome shotgun sequence",102087,36,27,48,77,188
"NW_020167996.1 Populus trichocarpa isolate Nisqually-1 unplaced genomic scaffold, Pop_tri_v3 scaffold_230, whole genome shotgun sequence",60521,396,121,181,451,1149
"NW_020167997.1 Populus trichocarpa isolate Nisqually-1 unplaced genomic scaffold, Pop_tri_v3 scaffold_232, whole genome shotgun sequence",61345,523,138,260,698,1619
"NW_020167998.1 Populus trichocarpa isolate Nisqually-1 unplaced genomic scaffold, Pop_tri_v3 scaffold_233, whole genome shotgun sequence",60227,465,178,231,593,1467
"NW_020167999.1 Populus trichocarpa isolate Nisqually-1 unplaced genomic scaffold, Pop_tri_v3 scaffold_237, whole genome shotgun sequence",77769,464,106,241,461,1272
"NW_020168000.1 Populus trichocarpa isolate Nisqually-1 unplaced genomic scaffold, Pop_tri_v3 scaffold_238, whole genome shotgun sequence",68591,507,167,240,680,1594
"NW_020168001.1 Populus trichocarpa isolate Nisqually-1 unplaced genomic scaffold, Pop_tri_v3 scaffold_240, whole genome shotgun sequence",127782,41,56,36,48,181
"NW_020168002.1 Populus trichocarpa isolate Nisqually-1 unplaced genomic scaffold, Pop_tri_v3 scaffold_241, whole genome shotgun sequence",74068,639,226,310,754,1929
"NW_020168003.1 Populus trichocarpa isolate Nisqually-1 unplaced genomic scaffold, Pop_tri_v3 scaffold_250, whole genome shotgun sequence",55372,552,103,238,634,1527
"NW_020168004.1 Populus trichocarpa isolate Nisqually-1 unplaced genomic scaffold, Pop_tri_v3 scaffold_252, whole genome shotgun sequence",66214,466,153,281,585,1485
"NW_020168005.1 Populus trichocarpa isolate Nisqually-1 unplaced genomic scaffold, Pop_tri_v3 scaffold_254, whole genome shotgun sequence",123230,32,11,34,7,84
"NW_020168006.1 Populus trichocarpa isolate Nisqually-1 unplaced genomic scaffold, Pop_tri_v3 scaffold_256, whole genome shotgun sequence",53559,343,145,215,420,1123
"NW_020168007.1 Populus trichocarpa isolate Nisqually-1 unplaced genomic scaffold, Pop_tri_v3 scaffold_258, whole genome shotgun sequence",54721,471,111,226,445,1253
"NW_020168008.1 Populus trichocarpa isolate Nisqually-1 unplaced genomic scaffold, Pop_tri_v3 scaffold_259, whole genome shotgun sequence",88892,312,75,182,351,920
"NW_020168009.1 Populus trichocarpa isolate Nisqually-1 unplaced genomic scaffold, Pop_tri_v3 scaffold_263, whole genome shotgun sequence",81722,485,133,228,593,1439
"NW_020168010.1 Populus trichocarpa isolate Nisqually-1 unplaced genomic scaffold, Pop_tri_v3 scaffold_264, whole genome shotgun sequence",52633,482,140,234,633,1489
"NW_020168011.1 Populus trichocarpa isolate Nisqually-1 unplaced genomic scaffold, Pop_tri_v3 scaffold_265, whole genome shotgun sequence",53179,285,151,137,309,882
"NW_020168012.1 Populus trichocarpa isolate Nisqually-1 unplaced genomic scaffold, Pop_tri_v3 scaffold_268, whole genome shotgun sequence",51538,415,153,209,494,1271
"NW_020168013.1 Populus trichocarpa isolate Nisqually-1 unplaced genomic scaffold, Pop_tri_v3 scaffold_270, whole genome shotgun sequence",51148,398,137,184,531,1250
"NW_020168014.1 Populus trichocarpa isolate Nisqually-1 unplaced genomic scaffold, Pop_tri_v3 scaffold_273, whole genome shotgun sequence",53986,454,113,246,566,1379
"NW_020168015.1 Populus trichocarpa isolate Nisqually-1 unplaced genomic scaffold, Pop_tri_v3 scaffold_276, whole genome shotgun sequence",61816,83,61,40,129,313
"NW_020168016.1 Populus trichocarpa isolate Nisqually-1 unplaced genomic scaffold, Pop_tri_v3 scaffold_278, whole genome shotgun sequence",50870,368,92,158,422,1040
"NW_020168017.1 Populus trichocarpa isolate Nisqually-1 unplaced genomic scaffold, Pop_tri_v3 scaffold_283, whole genome shotgun sequence",48862,406,129,226,438,1199
"NW_020168018.1 Populus trichocarpa isolate Nisqually-1 unplaced genomic scaffold, Pop_tri_v3 scaffold_289, whole genome shotgun sequence",49065,409,117,186,485,1197
"NW_020168019.1 Populus trichocarpa isolate Nisqually-1 unplaced genomic scaffold, Pop_tri_v3 scaffold_291, whole genome shotgun sequence",48500,436,148,224,628,1436
"NW_020168020.1 Populus trichocarpa isolate Nisqually-1 unplaced genomic scaffold, Pop_tri_v3 scaffold_294, whole genome shotgun sequence",47539,233,75,134,350,792
"NW_020168021.1 Populus trichocarpa isolate Nisqually-1 unplaced genomic scaffold, Pop_tri_v3 scaffold_295, whole genome shotgun sequence",51270,398,92,165,407,1062
"NW_020168022.1 Populus trichocarpa isolate Nisqually-1 unplaced genomic scaffold, Pop_tri_v3 scaffold_299, whole genome shotgun sequence",48297,443,79,182,447,1151
"NW_020168023.1 Populus trichocarpa isolate Nisqually-1 unplaced genomic scaffold, Pop_tri_v3 scaffold_301, whole genome shotgun sequence",46659,427,130,187,475,1219
"NW_020168024.1 Populus trichocarpa isolate Nisqually-1 unplaced genomic scaffold, Pop_tri_v3 scaffold_316, whole genome shotgun sequence",44877,284,107,138,395,924
"NW_020168025.1 Populus trichocarpa isolate Nisqually-1 unplaced genomic scaffold, Pop_tri_v3 scaffold_318, whole genome shotgun sequence",44959,333,74,110,358,875
"NW_020168026.1 Populus trichocarpa isolate Nisqually-1 unplaced genomic scaffold, Pop_tri_v3 scaffold_321, whole genome shotgun sequence",53468,320,90,176,361,947
"NW_020168027.1 Populus trichocarpa isolate Nisqually-1 unplaced genomic scaffold, Pop_tri_v3 scaffold_322, whole genome shotgun sequence",43173,243,77,106,276,702
"NW_020168028.1 Populus trichocarpa isolate Nisqually-1 unplaced genomic scaffold, Pop_tri_v3 scaffold_327, whole genome shotgun sequence",62962,381,51,155,373,960
"NW_020168029.1 Populus trichocarpa isolate Nisqually-1 unplaced genomic scaffold, Pop_tri_v3 scaffold_331, whole genome shotgun sequence",44098,453,116,198,414,1181
"NW_020168030.1 Populus trichocarpa isolate Nisqually-1 unplaced genomic scaffold, Pop_tri_v3 scaffold_334, whole genome shotgun sequence",41828,337,86,152,429,1004
"NW_020168031.1 Populus trichocarpa isolate Nisqually-1 unplaced genomic scaffold, Pop_tri_v3 scaffold_346, whole genome shotgun sequence",89124,529,913,698,642,2782
"NW_020168032.1 Populus trichocarpa isolate Nisqually-1 unplaced genomic scaffold, Pop_tri_v3 scaffold_357, whole genome shotgun sequence",40467,258,79,130,309,776
"NW_020168033.1 Populus trichocarpa isolate Nisqually-1 unplaced genomic scaffold, Pop_tri_v3 scaffold_375, whole genome shotgun sequence",61776,312,102,156,349,919
"NW_020168034.1 Populus trichocarpa isolate Nisqually-1 unplaced genomic scaffold, Pop_tri_v3 scaffold_376, whole genome shotgun sequence",38005,178,91,134,225,628
"NW_020168035.1 Populus trichocarpa isolate Nisqually-1 unplaced genomic scaffold, Pop_tri_v3 scaffold_381, whole genome shotgun sequence",38034,296,94,119,388,897
"NW_020168036.1 Populus trichocarpa isolate Nisqually-1 unplaced genomic scaffold, Pop_tri_v3 scaffold_384, whole genome shotgun sequence",40992,327,105,177,405,1014
"NW_020168037.1 Populus trichocarpa isolate Nisqually-1 unplaced genomic scaffold, Pop_tri_v3 scaffold_388, whole genome shotgun sequence",36630,349,89,153,399,990
"NW_020168038.1 Populus trichocarpa isolate Nisqually-1 unplaced genomic scaffold, Pop_tri_v3 scaffold_391, whole genome shotgun sequence",42045,280,100,117,333,830
"NW_020168039.1 Populus trichocarpa isolate Nisqually-1 unplaced genomic scaffold, Pop_tri_v3 scaffold_393, whole genome shotgun sequence",37573,242,90,120,301,753
"NW_020168040.1 Populus trichocarpa isolate Nisqually-1 unplaced genomic scaffold, Pop_tri_v3 scaffold_394, whole genome shotgun sequence",35951,268,122,154,377,921
"NW_020168041.1 Populus trichocarpa isolate Nisqually-1 unplaced genomic scaffold, Pop_tri_v3 scaffold_397, whole genome shotgun sequence",35893,167,88,95,227,577
"NW_020168042.1 Populus trichocarpa isolate Nisqually-1 unplaced genomic scaffold, Pop_tri_v3 scaffold_400, whole genome shotgun sequence",35813,191,78,120,228,617
"NW_020168043.1 Populus trichocarpa isolate Nisqually-1 unplaced genomic scaffold, Pop_tri_v3 scaffold_407, whole genome shotgun sequence",36288,268,106,141,314,829
"NW_020168044.1 Populus trichocarpa isolate Nisqually-1 unplaced genomic scaffold, Pop_tri_v3 scaffold_408, whole genome shotgun sequence",36404,281,75,144,352,852
"NW_020168045.1 Populus trichocarpa isolate Nisqually-1 unplaced genomic scaffold, Pop_tri_v3 scaffold_411, whole genome shotgun sequence",39623,199,47,83,210,539
"NW_020168046.1 Populus trichocarpa isolate Nisqually-1 unplaced genomic scaffold, Pop_tri_v3 scaffold_412, whole genome shotgun sequence",56583,252,75,131,228,686
"NW_020168047.1 Populus trichocarpa isolate Nisqually-1 unplaced genomic scaffold, Pop_tri_v3 scaffold_420, whole genome shotgun sequence",33881,97,47,59,122,325
"NW_020168048.1 Populus trichocarpa isolate Nisqually-1 unplaced genomic scaffold, Pop_tri_v3 scaffold_422, whole genome shotgun sequence",47702,336,68,154,422,980
"NW_020168049.1 Populus trichocarpa isolate Nisqually-1 unplaced genomic scaffold, Pop_tri_v3 scaffold_429, whole genome shotgun sequence",33575,44,18,11,85,158
"NW_020168050.1 Populus trichocarpa isolate Nisqually-1 unplaced genomic scaffold, Pop_tri_v3 scaffold_434, whole genome shotgun sequence",59958,215,61,110,211,597
"NW_020168051.1 Populus trichocarpa isolate Nisqually-1 unplaced genomic scaffold, Pop_tri_v3 scaffold_437, whole genome shotgun sequence",48921,210,72,104,264,650
"NW_020168052.1 Populus trichocarpa isolate Nisqually-1 unplaced genomic scaffold, Pop_tri_v3 scaffold_441, whole genome shotgun sequence",32132,223,81,130,317,751
"NW_020168053.1 Populus trichocarpa isolate Nisqually-1 unplaced genomic scaffold, Pop_tri_v3 scaffold_442, whole genome shotgun sequence",32015,199,26,65,252,542
"NW_020168054.1 Populus trichocarpa isolate Nisqually-1 unplaced genomic scaffold, Pop_tri_v3 scaffold_445, whole genome shotgun sequence",56858,237,83,130,302,752
"NW_020168055.1 Populus trichocarpa isolate Nisqually-1 unplaced genomic scaffold, Pop_tri_v3 scaffold_446, whole genome shotgun sequence",31311,226,67,146,229,668
"NW_020168056.1 Populus trichocarpa isolate Nisqually-1 unplaced genomic scaffold, Pop_tri_v3 scaffold_447, whole genome shotgun sequence",31167,226,65,94,273,658
"NW_020168057.1 Populus trichocarpa isolate Nisqually-1 unplaced genomic scaffold, Pop_tri_v3 scaffold_449, whole genome shotgun sequence",31428,174,75,105,273,627
"NW_020168058.1 Populus trichocarpa isolate Nisqually-1 unplaced genomic scaffold, Pop_tri_v3 scaffold_455, whole genome shotgun sequence",62928,190,50,97,270,607
"NW_020168059.1 Populus trichocarpa isolate Nisqually-1 unplaced genomic scaffold, Pop_tri_v3 scaffold_456, whole genome shotgun sequence",30792,156,30,71,182,439
"NW_020168060.1 Populus trichocarpa isolate Nisqually-1 unplaced genomic scaffold, Pop_tri_v3 scaffold_457, whole genome shotgun sequence",30232,241,70,114,260,685
"NW_020168061.1 Populus trichocarpa isolate Nisqually-1 unplaced genomic scaffold, Pop_tri_v3 scaffold_459, whole genome shotgun sequence",30564,229,61,116,324,730
"NW_020168062.1 Populus trichocarpa isolate Nisqually-1 unplaced genomic scaffold, Pop_tri_v3 scaffold_462, whole genome shotgun sequence",29971,374,48,141,355,918
"NW_020168063.1 Populus trichocarpa isolate Nisqually-1 unplaced genomic scaffold, Pop_tri_v3 scaffold_463, whole genome shotgun sequence",30284,258,68,139,304,769
"NW_020168064.1 Populus trichocarpa isolate Nisqually-1 unplaced genomic scaffold, Pop_tri_v3 scaffold_465, whole genome shotgun sequence",55750,117,25,40,150,332
"NW_020168065.1 Populus trichocarpa isolate Nisqually-1 unplaced genomic scaffold, Pop_tri_v3 scaffold_466, whole genome shotgun sequence",47042,157,54,93,246,550
"NW_020168066.1 Populus trichocarpa isolate Nisqually-1 unplaced genomic scaffold, Pop_tri_v3 scaffold_467, whole genome shotgun sequence",30920,231,77,121,301,730
"NW_020168067.1 Populus trichocarpa isolate Nisqually-1 unplaced genomic scaffold, Pop_tri_v3 scaffold_472, whole genome shotgun sequence",30569,223,42,83,229,577
"NW_020168068.1 Populus trichocarpa isolate Nisqually-1 unplaced genomic scaffold, Pop_tri_v3 scaffold_473, whole genome shotgun sequence",33914,219,34,105,294,652
"NW_020168069.1 Populus trichocarpa isolate Nisqually-1 unplaced genomic scaffold, Pop_tri_v3 scaffold_476, whole genome shotgun sequence",85807,37,34,34,41,146
"NW_020168070.1 Populus trichocarpa isolate Nisqually-1 unplaced genomic scaffold, Pop_tri_v3 scaffold_478, whole genome shotgun sequence",29321,100,35,46,91,272
"NW_020168071.1 Populus trichocarpa isolate Nisqually-1 unplaced genomic scaffold, Pop_tri_v3 scaffold_479, whole genome shotgun sequence",29137,271,83,140,352,846
"NW_020168072.1 Populus trichocarpa isolate Nisqually-1 unplaced genomic scaffold, Pop_tri_v3 scaffold_480, whole genome shotgun sequence",29929,260,68,155,368,851
"NW_020168073.1 Populus trichocarpa isolate Nisqually-1 unplaced genomic scaffold, Pop_tri_v3 scaffold_481, whole genome shotgun sequence",28895,120,46,76,154,396
"NW_020168074.1 Populus trichocarpa isolate Nisqually-1 unplaced genomic scaffold, Pop_tri_v3 scaffold_483, whole genome shotgun sequence",28770,182,27,55,177,441
"NW_020168075.1 Populus trichocarpa isolate Nisqually-1 unplaced genomic scaffold, Pop_tri_v3 scaffold_484, whole genome shotgun sequence",29867,208,73,111,290,682
"NW_020168076.1 Populus trichocarpa isolate Nisqually-1 unplaced genomic scaffold, Pop_tri_v3 scaffold_495, whole genome shotgun sequence",28388,239,77,126,292,734
"NW_020168077.1 Populus trichocarpa isolate Nisqually-1 unplaced genomic scaffold, Pop_tri_v3 scaffold_497, whole genome shotgun sequence",49817,109,16,25,106,256
"NW_020168078.1 Populus trichocarpa isolate Nisqually-1 unplaced genomic scaffold, Pop_tri_v3 scaffold_498, whole genome shotgun sequence",29257,207,48,98,264,617
"NW_020168079.1 Populus trichocarpa isolate Nisqually-1 unplaced genomic scaffold, Pop_tri_v3 scaffold_500, whole genome shotgun sequence",28176,277,50,154,400,881
"NW_020168080.1 Populus trichocarpa isolate Nisqually-1 unplaced genomic scaffold, Pop_tri_v3 scaffold_502, whole genome shotgun sequence",27890,111,29,53,72,265
"NW_020168081.1 Populus trichocarpa isolate Nisqually-1 unplaced genomic scaffold, Pop_tri_v3 scaffold_503, whole genome shotgun sequence",47842,234,76,91,280,681
"NW_020168082.1 Populus trichocarpa isolate Nisqually-1 unplaced genomic scaffold, Pop_tri_v3 scaffold_508, whole genome shotgun sequence",27200,235,36,100,239,610
"NW_020168083.1 Populus trichocarpa isolate Nisqually-1 unplaced genomic scaffold, Pop_tri_v3 scaffold_514, whole genome shotgun sequence",26784,229,91,118,267,705
"NW_020168084.1 Populus trichocarpa isolate Nisqually-1 unplaced genomic scaffold, Pop_tri_v3 scaffold_519, whole genome shotgun sequence",26272,246,43,100,304,693
"NW_020168085.1 Populus trichocarpa isolate Nisqually-1 unplaced genomic scaffold, Pop_tri_v3 scaffold_522, whole genome shotgun sequence",26433,215,63,110,241,629
"NW_020168086.1 Populus trichocarpa isolate Nisqually-1 unplaced genomic scaffold, Pop_tri_v3 scaffold_525, whole genome shotgun sequence",25932,125,41,66,185,417
"NW_020168087.1 Populus trichocarpa isolate Nisqually-1 unplaced genomic scaffold, Pop_tri_v3 scaffold_528, whole genome shotgun sequence",25539,209,61,114,249,633
"NW_020168088.1 Populus trichocarpa isolate Nisqually-1 unplaced genomic scaffold, Pop_tri_v3 scaffold_531, whole genome shotgun sequence",25482,161,47,93,218,519
"NW_020168089.1 Populus trichocarpa isolate Nisqually-1 unplaced genomic scaffold, Pop_tri_v3 scaffold_533, whole genome shotgun sequence",25519,210,53,103,246,612
"NW_020168090.1 Populus trichocarpa isolate Nisqually-1 unplaced genomic scaffold, Pop_tri_v3 scaffold_537, whole genome shotgun sequence",24941,189,30,72,176,467
"NW_020168091.1 Populus trichocarpa isolate Nisqually-1 unplaced genomic scaffold, Pop_tri_v3 scaffold_541, whole genome shotgun sequence",81610,39,32,27,45,143
"NW_020168092.1 Populus trichocarpa isolate Nisqually-1 unplaced genomic scaffold, Pop_tri_v3 scaffold_545, whole genome shotgun sequence",24590,211,60,94,246,611
"NW_020168093.1 Populus trichocarpa isolate Nisqually-1 unplaced genomic scaffold, Pop_tri_v3 scaffold_549, whole genome shotgun sequence",24964,190,53,86,212,541
"NW_020168094.1 Populus trichocarpa isolate Nisqually-1 unplaced genomic scaffold, Pop_tri_v3 scaffold_550, whole genome shotgun sequence",24341,162,59,73,173,467
"NW_020168095.1 Populus trichocarpa isolate Nisqually-1 unplaced genomic scaffold, Pop_tri_v3 scaffold_555, whole genome shotgun sequence",23828,212,87,117,288,704
"NW_020168096.1 Populus trichocarpa isolate Nisqually-1 unplaced genomic scaffold, Pop_tri_v3 scaffold_558, whole genome shotgun sequence",23902,215,77,128,211,631
"NW_020168097.1 Populus trichocarpa isolate Nisqually-1 unplaced genomic scaffold, Pop_tri_v3 scaffold_559, whole genome shotgun sequence",25151,60,17,23,69,169
"NW_020168098.1 Populus trichocarpa isolate Nisqually-1 unplaced genomic scaffold, Pop_tri_v3 scaffold_560, whole genome shotgun sequence",24233,225,71,97,267,660
"NW_020168099.1 Populus trichocarpa isolate Nisqually-1 unplaced genomic scaffold, Pop_tri_v3 scaffold_561, whole genome shotgun sequence",23558,122,28,65,140,355
"NW_020168100.1 Populus trichocarpa isolate Nisqually-1 unplaced genomic scaffold, Pop_tri_v3 scaffold_567, whole genome shotgun sequence",23534,235,46,127,223,631
"NW_020168101.1 Populus trichocarpa isolate Nisqually-1 unplaced genomic scaffold, Pop_tri_v3 scaffold_570, whole genome shotgun sequence",23383,149,77,97,199,522
"NW_020168102.1 Populus trichocarpa isolate Nisqually-1 unplaced genomic scaffold, Pop_tri_v3 scaffold_575, whole genome shotgun sequence",29931,9,3,3,10,25
"NW_020168103.1 Populus trichocarpa isolate Nisqually-1 unplaced genomic scaffold, Pop_tri_v3 scaffold_576, whole genome shotgun sequence",23531,206,38,89,242,575
"NW_020168104.1 Populus trichocarpa isolate Nisqually-1 unplaced genomic scaffold, Pop_tri_v3 scaffold_578, whole genome shotgun sequence",23184,256,32,117,231,636
"NW_020168105.1 Populus trichocarpa isolate Nisqually-1 unplaced genomic scaffold, Pop_tri_v3 scaffold_580, whole genome shotgun sequence",24467,196,24,100,227,547
"NW_020168106.1 Populus trichocarpa isolate Nisqually-1 unplaced genomic scaffold, Pop_tri_v3 scaffold_581, whole genome shotgun sequence",22884,167,31,87,196,481
"NW_020168107.1 Populus trichocarpa isolate Nisqually-1 unplaced genomic scaffold, Pop_tri_v3 scaffold_584, whole genome shotgun sequence",23030,205,47,92,236,580
"NW_020168108.1 Populus trichocarpa isolate Nisqually-1 unplaced genomic scaffold, Pop_tri_v3 scaffold_585, whole genome shotgun sequence",23375,103,50,70,137,360
"NW_020168109.1 Populus trichocarpa isolate Nisqually-1 unplaced genomic scaffold, Pop_tri_v3 scaffold_586, whole genome shotgun sequence",22611,182,54,96,247,579
"NW_020168110.1 Populus trichocarpa isolate Nisqually-1 unplaced genomic scaffold, Pop_tri_v3 scaffold_589, whole genome shotgun sequence",22571,124,18,62,177,381
"NW_020168111.1 Populus trichocarpa isolate Nisqually-1 unplaced genomic scaffold, Pop_tri_v3 scaffold_592, whole genome shotgun sequence",22499,318,56,115,301,790
"NW_020168112.1 Populus trichocarpa isolate Nisqually-1 unplaced genomic scaffold, Pop_tri_v3 scaffold_598, whole genome shotgun sequence",22416,192,64,100,287,643
"NW_020168113.1 Populus trichocarpa isolate Nisqually-1 unplaced genomic scaffold, Pop_tri_v3 scaffold_601, whole genome shotgun sequence",22075,128,20,57,182,387
"NW_020168114.1 Populus trichocarpa isolate Nisqually-1 unplaced genomic scaffold, Pop_tri_v3 scaffold_605, whole genome shotgun sequence",22332,175,40,110,220,545
"NW_020168115.1 Populus trichocarpa isolate Nisqually-1 unplaced genomic scaffold, Pop_tri_v3 scaffold_607, whole genome shotgun sequence",21822,144,48,71,187,450
"NW_020168116.1 Populus trichocarpa isolate Nisqually-1 unplaced genomic scaffold, Pop_tri_v3 scaffold_608, whole genome shotgun sequence",21707,161,55,79,190,485
"NW_020168117.1 Populus trichocarpa isolate Nisqually-1 unplaced genomic scaffold, Pop_tri_v3 scaffold_609, whole genome shotgun sequence",21685,245,39,106,244,634
"NW_020168118.1 Populus trichocarpa isolate Nisqually-1 unplaced genomic scaffold, Pop_tri_v3 scaffold_610, whole genome shotgun sequence",45096,155,51,83,219,508
"NW_020168119.1 Populus trichocarpa isolate Nisqually-1 unplaced genomic scaffold, Pop_tri_v3 scaffold_611, whole genome shotgun sequence",21623,210,61,117,259,647
"NW_020168120.1 Populus trichocarpa isolate Nisqually-1 unplaced genomic scaffold, Pop_tri_v3 scaffold_612, whole genome shotgun sequence",21598,143,34,71,120,368
"NW_020168121.1 Populus trichocarpa isolate Nisqually-1 unplaced genomic scaffold, Pop_tri_v3 scaffold_613, whole genome shotgun sequence",22033,188,26,69,155,438
"NW_020168122.1 Populus trichocarpa isolate Nisqually-1 unplaced genomic scaffold, Pop_tri_v3 scaffold_615, whole genome shotgun sequence",25235,32,39,6,42,119
"NW_020168123.1 Populus trichocarpa isolate Nisqually-1 unplaced genomic scaffold, Pop_tri_v3 scaffold_621, whole genome shotgun sequence",23289,150,45,83,207,485
"NW_020168124.1 Populus trichocarpa isolate Nisqually-1 unplaced genomic scaffold, Pop_tri_v3 scaffold_624, whole genome shotgun sequence",21955,95,32,42,102,271
"NW_020168125.1 Populus trichocarpa isolate Nisqually-1 unplaced genomic scaffold, Pop_tri_v3 scaffold_627, whole genome shotgun sequence",21510,47,20,17,71,155
"NW_020168126.1 Populus trichocarpa isolate Nisqually-1 unplaced genomic scaffold, Pop_tri_v3 scaffold_632, whole genome shotgun sequence",20826,64,29,44,82,219
"NW_020168127.1 Populus trichocarpa isolate Nisqually-1 unplaced genomic scaffold, Pop_tri_v3 scaffold_633, whole genome shotgun sequence",20940,116,57,49,172,394
"NW_020168128.1 Populus trichocarpa isolate Nisqually-1 unplaced genomic scaffold, Pop_tri_v3 scaffold_644, whole genome shotgun sequence",21344,199,55,110,300,664
"NW_020168129.1 Populus trichocarpa isolate Nisqually-1 unplaced genomic scaffold, Pop_tri_v3 scaffold_645, whole genome shotgun sequence",20520,198,50,117,252,617
"NW_020168130.1 Populus trichocarpa isolate Nisqually-1 unplaced genomic scaffold, Pop_tri_v3 scaffold_648, whole genome shotgun sequence",20762,88,45,51,109,293
"NW_020168131.1 Populus trichocarpa isolate Nisqually-1 unplaced genomic scaffold, Pop_tri_v3 scaffold_650, whole genome shotgun sequence",20531,177,47,57,201,482
"NW_020168132.1 Populus trichocarpa isolate Nisqually-1 unplaced genomic scaffold, Pop_tri_v3 scaffold_655, whole genome shotgun sequence",20344,179,81,112,202,574
"NW_020168133.1 Populus trichocarpa isolate Nisqually-1 unplaced genomic scaffold, Pop_tri_v3 scaffold_658, whole genome shotgun sequence",21280,136,28,65,151,380
"NW_020168134.1 Populus trichocarpa isolate Nisqually-1 unplaced genomic scaffold, Pop_tri_v3 scaffold_662, whole genome shotgun sequence",20801,214,48,81,227,570
"NW_020168135.1 Populus trichocarpa isolate Nisqually-1 unplaced genomic scaffold, Pop_tri_v3 scaffold_669, whole genome shotgun sequence",22127,10,6,3,5,24
"NW_020168136.1 Populus trichocarpa isolate Nisqually-1 unplaced genomic scaffold, Pop_tri_v3 scaffold_670, whole genome shotgun sequence",20822,180,56,97,234,567
"NW_020168137.1 Populus trichocarpa isolate Nisqually-1 unplaced genomic scaffold, Pop_tri_v3 scaffold_671, whole genome shotgun sequence",20582,44,21,35,77,177
"NW_020168138.1 Populus trichocarpa isolate Nisqually-1 unplaced genomic scaffold, Pop_tri_v3 scaffold_675, whole genome shotgun sequence",19993,200,62,84,246,592
"NW_020168139.1 Populus trichocarpa isolate Nisqually-1 unplaced genomic scaffold, Pop_tri_v3 scaffold_676, whole genome shotgun sequence",19543,133,55,80,243,511
"NW_020168140.1 Populus trichocarpa isolate Nisqually-1 unplaced genomic scaffold, Pop_tri_v3 scaffold_678, whole genome shotgun sequence",19664,127,40,75,184,426
"NW_020168141.1 Populus trichocarpa isolate Nisqually-1 unplaced genomic scaffold, Pop_tri_v3 scaffold_679, whole genome shotgun sequence",19390,192,60,98,216,566
"NW_020168142.1 Populus trichocarpa isolate Nisqually-1 unplaced genomic scaffold, Pop_tri_v3 scaffold_684, whole genome shotgun sequence",19453,164,59,70,173,466
"NW_020168143.1 Populus trichocarpa isolate Nisqually-1 unplaced genomic scaffold, Pop_tri_v3 scaffold_691, whole genome shotgun sequence",39733,6,5,13,13,37
"NW_020168144.1 Populus trichocarpa isolate Nisqually-1 unplaced genomic scaffold, Pop_tri_v3 scaffold_694, whole genome shotgun sequence",19414,178,66,101,217,562
"NW_020168145.1 Populus trichocarpa isolate Nisqually-1 unplaced genomic scaffold, Pop_tri_v3 scaffold_696, whole genome shotgun sequence",19110,133,27,59,141,360
"NW_020168146.1 Populus trichocarpa isolate Nisqually-1 unplaced genomic scaffold, Pop_tri_v3 scaffold_697, whole genome shotgun sequence",41424,130,46,66,207,449
"NW_020168147.1 Populus trichocarpa isolate Nisqually-1 unplaced genomic scaffold, Pop_tri_v3 scaffold_698, whole genome shotgun sequence",19103,130,41,53,168,392
"NW_020168148.1 Populus trichocarpa isolate Nisqually-1 unplaced genomic scaffold, Pop_tri_v3 scaffold_702, whole genome shotgun sequence",20132,194,49,92,244,579
"NW_020168149.1 Populus trichocarpa isolate Nisqually-1 unplaced genomic scaffold, Pop_tri_v3 scaffold_703, whole genome shotgun sequence",19120,154,52,66,174,446
"NW_020168150.1 Populus trichocarpa isolate Nisqually-1 unplaced genomic scaffold, Pop_tri_v3 scaffold_704, whole genome shotgun sequence",19317,87,51,39,111,288
"NW_020168151.1 Populus trichocarpa isolate Nisqually-1 unplaced genomic scaffold, Pop_tri_v3 scaffold_705, whole genome shotgun sequence",18948,176,54,73,215,518
"NW_020168152.1 Populus trichocarpa isolate Nisqually-1 unplaced genomic scaffold, Pop_tri_v3 scaffold_711, whole genome shotgun sequence",19501,204,69,141,176,590
"NW_020168153.1 Populus trichocarpa isolate Nisqually-1 unplaced genomic scaffold, Pop_tri_v3 scaffold_717, whole genome shotgun sequence",18696,27,8,16,43,94
"NW_020168154.1 Populus trichocarpa isolate Nisqually-1 unplaced genomic scaffold, Pop_tri_v3 scaffold_718, whole genome shotgun sequence",18642,194,89,110,186,579
"NW_020168155.1 Populus trichocarpa isolate Nisqually-1 unplaced genomic scaffold, Pop_tri_v3 scaffold_721, whole genome shotgun sequence",19702,184,58,76,220,538
"NW_020168156.1 Populus trichocarpa isolate Nisqually-1 unplaced genomic scaffold, Pop_tri_v3 scaffold_723, whole genome shotgun sequence",19483,103,33,49,127,312
"NW_020168157.1 Populus trichocarpa isolate Nisqually-1 unplaced genomic scaffold, Pop_tri_v3 scaffold_726, whole genome shotgun sequence",18912,160,52,86,125,423
"NW_020168158.1 Populus trichocarpa isolate Nisqually-1 unplaced genomic scaffold, Pop_tri_v3 scaffold_728, whole genome shotgun sequence",18569,242,44,119,269,674
"NW_020168159.1 Populus trichocarpa isolate Nisqually-1 unplaced genomic scaffold, Pop_tri_v3 scaffold_733, whole genome shotgun sequence",18413,135,47,61,191,434
"NW_020168160.1 Populus trichocarpa isolate Nisqually-1 unplaced genomic scaffold, Pop_tri_v3 scaffold_737, whole genome shotgun sequence",18694,179,64,102,227,572
"NW_020168161.1 Populus trichocarpa isolate Nisqually-1 unplaced genomic scaffold, Pop_tri_v3 scaffold_742, whole genome shotgun sequence",18263,118,29,42,125,314
"NW_020168162.1 Populus trichocarpa isolate Nisqually-1 unplaced genomic scaffold, Pop_tri_v3 scaffold_743, whole genome shotgun sequence",49037,12,8,6,9,35
"NW_020168163.1 Populus trichocarpa isolate Nisqually-1 unplaced genomic scaffold, Pop_tri_v3 scaffold_744, whole genome shotgun sequence",19762,145,43,78,189,455
"NW_020168164.1 Populus trichocarpa isolate Nisqually-1 unplaced genomic scaffold, Pop_tri_v3 scaffold_746, whole genome shotgun sequence",18163,133,29,65,144,371
"NW_020168165.1 Populus trichocarpa isolate Nisqually-1 unplaced genomic scaffold, Pop_tri_v3 scaffold_750, whole genome shotgun sequence",18062,167,46,71,178,462
"NW_020168166.1 Populus trichocarpa isolate Nisqually-1 unplaced genomic scaffold, Pop_tri_v3 scaffold_752, whole genome shotgun sequence",18036,200,49,116,268,633
"NW_020168167.1 Populus trichocarpa isolate Nisqually-1 unplaced genomic scaffold, Pop_tri_v3 scaffold_754, whole genome shotgun sequence",18527,119,23,51,132,325
"NW_020168168.1 Populus trichocarpa isolate Nisqually-1 unplaced genomic scaffold, Pop_tri_v3 scaffold_755, whole genome shotgun sequence",18201,137,46,68,183,434
"NW_020168169.1 Populus trichocarpa isolate Nisqually-1 unplaced genomic scaffold, Pop_tri_v3 scaffold_758, whole genome shotgun sequence",17919,120,40,61,139,360
"NW_020168170.1 Populus trichocarpa isolate Nisqually-1 unplaced genomic scaffold, Pop_tri_v3 scaffold_762, whole genome shotgun sequence",18555,91,38,72,144,345
"NW_020168171.1 Populus trichocarpa isolate Nisqually-1 unplaced genomic scaffold, Pop_tri_v3 scaffold_766, whole genome shotgun sequence",18033,182,46,84,210,522
"NW_020168172.1 Populus trichocarpa isolate Nisqually-1 unplaced genomic scaffold, Pop_tri_v3 scaffold_769, whole genome shotgun sequence",17699,120,37,60,113,330
"NW_020168173.1 Populus trichocarpa isolate Nisqually-1 unplaced genomic scaffold, Pop_tri_v3 scaffold_771, whole genome shotgun sequence",17782,94,36,55,139,324
"NW_020168174.1 Populus trichocarpa isolate Nisqually-1 unplaced genomic scaffold, Pop_tri_v3 scaffold_772, whole genome shotgun sequence",17840,162,70,73,181,486
"NW_020168175.1 Populus trichocarpa isolate Nisqually-1 unplaced genomic scaffold, Pop_tri_v3 scaffold_779, whole genome shotgun sequence",19307,91,41,54,119,305
"NW_020168176.1 Populus trichocarpa isolate Nisqually-1 unplaced genomic scaffold, Pop_tri_v3 scaffold_782, whole genome shotgun sequence",17458,124,42,70,194,430
"NW_020168177.1 Populus trichocarpa isolate Nisqually-1 unplaced genomic scaffold, Pop_tri_v3 scaffold_784, whole genome shotgun sequence",17446,107,33,52,107,299
"NW_020168178.1 Populus trichocarpa isolate Nisqually-1 unplaced genomic scaffold, Pop_tri_v3 scaffold_790, whole genome shotgun sequence",19823,11,51,21,71,154
"NW_020168179.1 Populus trichocarpa isolate Nisqually-1 unplaced genomic scaffold, Pop_tri_v3 scaffold_791, whole genome shotgun sequence",17205,139,33,62,148,382
"NW_020168180.1 Populus trichocarpa isolate Nisqually-1 unplaced genomic scaffold, Pop_tri_v3 scaffold_793, whole genome shotgun sequence",17402,95,31,65,141,332
"NW_020168181.1 Populus trichocarpa isolate Nisqually-1 unplaced genomic scaffold, Pop_tri_v3 scaffold_797, whole genome shotgun sequence",19758,148,48,83,141,420
"NW_020168182.1 Populus trichocarpa isolate Nisqually-1 unplaced genomic scaffold, Pop_tri_v3 scaffold_800, whole genome shotgun sequence",17050,204,29,70,184,487
"NW_020168183.1 Populus trichocarpa isolate Nisqually-1 unplaced genomic scaffold, Pop_tri_v3 scaffold_802, whole genome shotgun sequence",18417,155,57,78,226,516
"NW_020168184.1 Populus trichocarpa isolate Nisqually-1 unplaced genomic scaffold, Pop_tri_v3 scaffold_806, whole genome shotgun sequence",18114,60,23,34,74,191
"NW_020168185.1 Populus trichocarpa isolate Nisqually-1 unplaced genomic scaffold, Pop_tri_v3 scaffold_811, whole genome shotgun sequence",27299,127,27,47,120,321
"NW_020168186.1 Populus trichocarpa isolate Nisqually-1 unplaced genomic scaffold, Pop_tri_v3 scaffold_813, whole genome shotgun sequence",16884,110,50,66,137,363
"NW_020168187.1 Populus trichocarpa isolate Nisqually-1 unplaced genomic scaffold, Pop_tri_v3 scaffold_814, whole genome shotgun sequence",17050,16,17,13,23,69
"NW_020168188.1 Populus trichocarpa isolate Nisqually-1 unplaced genomic scaffold, Pop_tri_v3 scaffold_816, whole genome shotgun sequence",16759,76,33,49,110,268
"NW_020168189.1 Populus trichocarpa isolate Nisqually-1 unplaced genomic scaffold, Pop_tri_v3 scaffold_817, whole genome shotgun sequence",16729,107,42,62,126,337
"NW_020168190.1 Populus trichocarpa isolate Nisqually-1 unplaced genomic scaffold, Pop_tri_v3 scaffold_819, whole genome shotgun sequence",16804,70,21,37,111,239
"NW_020168191.1 Populus trichocarpa isolate Nisqually-1 unplaced genomic scaffold, Pop_tri_v3 scaffold_821, whole genome shotgun sequence",16558,132,48,91,198,469
"NW_020168192.1 Populus trichocarpa isolate Nisqually-1 unplaced genomic scaffold, Pop_tri_v3 scaffold_822, whole genome shotgun sequence",16646,190,26,66,197,479
"NW_020168193.1 Populus trichocarpa isolate Nisqually-1 unplaced genomic scaffold, Pop_tri_v3 scaffold_823, whole genome shotgun sequence",16526,132,47,67,200,446
"NW_020168194.1 Populus trichocarpa isolate Nisqually-1 unplaced genomic scaffold, Pop_tri_v3 scaffold_824, whole genome shotgun sequence",17016,173,44,75,167,459
"NW_020168195.1 Populus trichocarpa isolate Nisqually-1 unplaced genomic scaffold, Pop_tri_v3 scaffold_825, whole genome shotgun sequence",16516,21,8,13,29,71
"NW_020168196.1 Populus trichocarpa isolate Nisqually-1 unplaced genomic scaffold, Pop_tri_v3 scaffold_827, whole genome shotgun sequence",18938,18,7,2,9,36
"NW_020168197.1 Populus trichocarpa isolate Nisqually-1 unplaced genomic scaffold, Pop_tri_v3 scaffold_828, whole genome shotgun sequence",16661,128,56,82,187,453
"NW_020168198.1 Populus trichocarpa isolate Nisqually-1 unplaced genomic scaffold, Pop_tri_v3 scaffold_833, whole genome shotgun sequence",17637,258,41,100,284,683
"NW_020168199.1 Populus trichocarpa isolate Nisqually-1 unplaced genomic scaffold, Pop_tri_v3 scaffold_835, whole genome shotgun sequence",16299,171,67,84,176,498
"NW_020168200.1 Populus trichocarpa isolate Nisqually-1 unplaced genomic scaffold, Pop_tri_v3 scaffold_838, whole genome shotgun sequence",16284,176,52,78,148,454
"NW_020168201.1 Populus trichocarpa isolate Nisqually-1 unplaced genomic scaffold, Pop_tri_v3 scaffold_839, whole genome shotgun sequence",16259,79,29,46,112,266
"NW_020168202.1 Populus trichocarpa isolate Nisqually-1 unplaced genomic scaffold, Pop_tri_v3 scaffold_843, whole genome shotgun sequence",16176,103,29,61,143,336
"NW_020168203.1 Populus trichocarpa isolate Nisqually-1 unplaced genomic scaffold, Pop_tri_v3 scaffold_845, whole genome shotgun sequence",16159,95,32,41,114,282
"NW_020168204.1 Populus trichocarpa isolate Nisqually-1 unplaced genomic scaffold, Pop_tri_v3 scaffold_855, whole genome shotgun sequence",16124,70,2,35,78,185
"NW_020168205.1 Populus trichocarpa isolate Nisqually-1 unplaced genomic scaffold, Pop_tri_v3 scaffold_858, whole genome shotgun sequence",42116,36,22,46,56,160
"NW_020168206.1 Populus trichocarpa isolate Nisqually-1 unplaced genomic scaffold, Pop_tri_v3 scaffold_861, whole genome shotgun sequence",16861,95,57,81,149,382
"NW_020168207.1 Populus trichocarpa isolate Nisqually-1 unplaced genomic scaffold, Pop_tri_v3 scaffold_862, whole genome shotgun sequence",15944,117,38,54,138,347
"NW_020168208.1 Populus trichocarpa isolate Nisqually-1 unplaced genomic scaffold, Pop_tri_v3 scaffold_863, whole genome shotgun sequence",15930,146,56,61,178,441
"NW_020168209.1 Populus trichocarpa isolate Nisqually-1 unplaced genomic scaffold, Pop_tri_v3 scaffold_865, whole genome shotgun sequence",16052,130,38,63,146,377
"NW_020168210.1 Populus trichocarpa isolate Nisqually-1 unplaced genomic scaffold, Pop_tri_v3 scaffold_866, whole genome shotgun sequence",15856,170,24,77,154,425
"NW_020168211.1 Populus trichocarpa isolate Nisqually-1 unplaced genomic scaffold, Pop_tri_v3 scaffold_867, whole genome shotgun sequence",15841,168,82,93,271,614
"NW_020168212.1 Populus trichocarpa isolate Nisqually-1 unplaced genomic scaffold, Pop_tri_v3 scaffold_871, whole genome shotgun sequence",15881,112,57,62,177,408
"NW_020168213.1 Populus trichocarpa isolate Nisqually-1 unplaced genomic scaffold, Pop_tri_v3 scaffold_873, whole genome shotgun sequence",15745,142,34,50,155,381
"NW_020168214.1 Populus trichocarpa isolate Nisqually-1 unplaced genomic scaffold, Pop_tri_v3 scaffold_876, whole genome shotgun sequence",16071,38,19,28,62,147
"NW_020168215.1 Populus trichocarpa isolate Nisqually-1 unplaced genomic scaffold, Pop_tri_v3 scaffold_877, whole genome shotgun sequence",15675,153,11,46,145,355
"NW_020168216.1 Populus trichocarpa isolate Nisqually-1 unplaced genomic scaffold, Pop_tri_v3 scaffold_880, whole genome shotgun sequence",16400,36,25,6,44,111
"NW_020168217.1 Populus trichocarpa isolate Nisqually-1 unplaced genomic scaffold, Pop_tri_v3 scaffold_883, whole genome shotgun sequence",16768,112,44,66,111,333
"NW_020168218.1 Populus trichocarpa isolate Nisqually-1 unplaced genomic scaffold, Pop_tri_v3 scaffold_888, whole genome shotgun sequence",17046,113,35,57,106,311
"NW_020168219.1 Populus trichocarpa isolate Nisqually-1 unplaced genomic scaffold, Pop_tri_v3 scaffold_894, whole genome shotgun sequence",15549,134,47,72,166,419
"NW_020168220.1 Populus trichocarpa isolate Nisqually-1 unplaced genomic scaffold, Pop_tri_v3 scaffold_898, whole genome shotgun sequence",15842,129,12,45,168,354
"NW_020168221.1 Populus trichocarpa isolate Nisqually-1 unplaced genomic scaffold, Pop_tri_v3 scaffold_899, whole genome shotgun sequence",15162,117,39,56,135,347
"NW_020168222.1 Populus trichocarpa isolate Nisqually-1 unplaced genomic scaffold, Pop_tri_v3 scaffold_900, whole genome shotgun sequence",15089,73,31,38,76,218
"NW_020168223.1 Populus trichocarpa isolate Nisqually-1 unplaced genomic scaffold, Pop_tri_v3 scaffold_903, whole genome shotgun sequence",45683,2,1,5,2,10
"NW_020168224.1 Populus trichocarpa isolate Nisqually-1 unplaced genomic scaffold, Pop_tri_v3 scaffold_905, whole genome shotgun sequence",15033,93,27,49,105,274
"NW_020168225.1 Populus trichocarpa isolate Nisqually-1 unplaced genomic scaffold, Pop_tri_v3 scaffold_908, whole genome shotgun sequence",15005,176,28,78,177,459
"NW_020168226.1 Populus trichocarpa isolate Nisqually-1 unplaced genomic scaffold, Pop_tri_v3 scaffold_911, whole genome shotgun sequence",15153,93,10,58,105,266
"NW_020168227.1 Populus trichocarpa isolate Nisqually-1 unplaced genomic scaffold, Pop_tri_v3 scaffold_912, whole genome shotgun sequence",15754,54,54,46,76,230
"NW_020168228.1 Populus trichocarpa isolate Nisqually-1 unplaced genomic scaffold, Pop_tri_v3 scaffold_913, whole genome shotgun sequence",14933,90,42,46,119,297
"NW_020168229.1 Populus trichocarpa isolate Nisqually-1 unplaced genomic scaffold, Pop_tri_v3 scaffold_916, whole genome shotgun sequence",15225,86,29,60,97,272
"NW_020168230.1 Populus trichocarpa isolate Nisqually-1 unplaced genomic scaffold, Pop_tri_v3 scaffold_918, whole genome shotgun sequence",14849,117,40,42,106,305
"NW_020168231.1 Populus trichocarpa isolate Nisqually-1 unplaced genomic scaffold, Pop_tri_v3 scaffold_922, whole genome shotgun sequence",16164,109,54,65,130,358
"NW_020168232.1 Populus trichocarpa isolate Nisqually-1 unplaced genomic scaffold, Pop_tri_v3 scaffold_923, whole genome shotgun sequence",14800,197,41,41,159,438
"NW_020168233.1 Populus trichocarpa isolate Nisqually-1 unplaced genomic scaffold, Pop_tri_v3 scaffold_925, whole genome shotgun sequence",15421,83,39,44,133,299
"NW_020168234.1 Populus trichocarpa isolate Nisqually-1 unplaced genomic scaffold, Pop_tri_v3 scaffold_927, whole genome shotgun sequence",14757,136,30,56,179,401
"NW_020168235.1 Populus trichocarpa isolate Nisqually-1 unplaced genomic scaffold, Pop_tri_v3 scaffold_929, whole genome shotgun sequence",15698,84,28,51,66,229
"NW_020168236.1 Populus trichocarpa isolate Nisqually-1 unplaced genomic scaffold, Pop_tri_v3 scaffold_933, whole genome shotgun sequence",42197,5,3,4,6,18
"NW_020168237.1 Populus trichocarpa isolate Nisqually-1 unplaced genomic scaffold, Pop_tri_v3 scaffold_938, whole genome shotgun sequence",16011,72,43,47,92,254
"NW_020168238.1 Populus trichocarpa isolate Nisqually-1 unplaced genomic scaffold, Pop_tri_v3 scaffold_940, whole genome shotgun sequence",15926,82,29,43,78,232
"NW_020168239.1 Populus trichocarpa isolate Nisqually-1 unplaced genomic scaffold, Pop_tri_v3 scaffold_943, whole genome shotgun sequence",14582,120,53,52,131,356
"NW_020168240.1 Populus trichocarpa isolate Nisqually-1 unplaced genomic scaffold, Pop_tri_v3 scaffold_946, whole genome shotgun sequence",14435,109,24,50,117,300
"NW_020168241.1 Populus trichocarpa isolate Nisqually-1 unplaced genomic scaffold, Pop_tri_v3 scaffold_947, whole genome shotgun sequence",16269,61,21,36,89,207
"NW_020168242.1 Populus trichocarpa isolate Nisqually-1 unplaced genomic scaffold, Pop_tri_v3 scaffold_948, whole genome shotgun sequence",14506,74,35,45,87,241
"NW_020168243.1 Populus trichocarpa isolate Nisqually-1 unplaced genomic scaffold, Pop_tri_v3 scaffold_949, whole genome shotgun sequence",15598,90,22,28,122,262
"NW_020168244.1 Populus trichocarpa isolate Nisqually-1 unplaced genomic scaffold, Pop_tri_v3 scaffold_954, whole genome shotgun sequence",14280,108,22,53,165,348
"NW_020168245.1 Populus trichocarpa isolate Nisqually-1 unplaced genomic scaffold, Pop_tri_v3 scaffold_960, whole genome shotgun sequence",14331,176,45,88,202,511
"NW_020168246.1 Populus trichocarpa isolate Nisqually-1 unplaced genomic scaffold, Pop_tri_v3 scaffold_965, whole genome shotgun sequence",14384,59,28,13,79,179
"NW_020168247.1 Populus trichocarpa isolate Nisqually-1 unplaced genomic scaffold, Pop_tri_v3 scaffold_966, whole genome shotgun sequence",14183,41,18,33,82,174
"NW_020168248.1 Populus trichocarpa isolate Nisqually-1 unplaced genomic scaffold, Pop_tri_v3 scaffold_970, whole genome shotgun sequence",14433,98,15,35,146,294
"NW_020168249.1 Populus trichocarpa isolate Nisqually-1 unplaced genomic scaffold, Pop_tri_v3 scaffold_975, whole genome shotgun sequence",14316,116,46,63,181,406
"NW_020168250.1 Populus trichocarpa isolate Nisqually-1 unplaced genomic scaffold, Pop_tri_v3 scaffold_978, whole genome shotgun sequence",14260,134,35,99,187,455
"NW_020168251.1 Populus trichocarpa isolate Nisqually-1 unplaced genomic scaffold, Pop_tri_v3 scaffold_982, whole genome shotgun sequence",14172,66,18,41,93,218
"NW_020168252.1 Populus trichocarpa isolate Nisqually-1 unplaced genomic scaffold, Pop_tri_v3 scaffold_987, whole genome shotgun sequence",15565,15,4,8,14,41
"NW_020168253.1 Populus trichocarpa isolate Nisqually-1 unplaced genomic scaffold, Pop_tri_v3 scaffold_988, whole genome shotgun sequence",13984,129,40,70,181,420
"NW_020168254.1 Populus trichocarpa isolate Nisqually-1 unplaced genomic scaffold, Pop_tri_v3 scaffold_990, whole genome shotgun sequence",14384,98,12,43,79,232
"NW_020168255.1 Populus trichocarpa isolate Nisqually-1 unplaced genomic scaffold, Pop_tri_v3 scaffold_991, whole genome shotgun sequence",14061,166,74,84,255,579
"NW_020168256.1 Populus trichocarpa isolate Nisqually-1 unplaced genomic scaffold, Pop_tri_v3 scaffold_995, whole genome shotgun sequence",13868,67,19,28,78,192
"NW_020168257.1 Populus trichocarpa isolate Nisqually-1 unplaced genomic scaffold, Pop_tri_v3 scaffold_996, whole genome shotgun sequence",14378,51,16,22,61,150
"NW_020168258.1 Populus trichocarpa isolate Nisqually-1 unplaced genomic scaffold, Pop_tri_v3 scaffold_1001, whole genome shotgun sequence",14045,116,25,48,139,328
"NW_020168259.1 Populus trichocarpa isolate Nisqually-1 unplaced genomic scaffold, Pop_tri_v3 scaffold_1005, whole genome shotgun sequence",15016,4,2,3,6,15
"NW_020168260.1 Populus trichocarpa isolate Nisqually-1 unplaced genomic scaffold, Pop_tri_v3 scaffold_1012, whole genome shotgun sequence",13660,168,29,94,227,518
"NW_020168261.1 Populus trichocarpa isolate Nisqually-1 unplaced genomic scaffold, Pop_tri_v3 scaffold_1014, whole genome shotgun sequence",13931,92,26,40,91,249
"NW_020168262.1 Populus trichocarpa isolate Nisqually-1 unplaced genomic scaffold, Pop_tri_v3 scaffold_1018, whole genome shotgun sequence",14622,96,31,50,142,319
"NW_020168263.1 Populus trichocarpa isolate Nisqually-1 unplaced genomic scaffold, Pop_tri_v3 scaffold_1021, whole genome shotgun sequence",13836,120,28,48,108,304
"NW_020168264.1 Populus trichocarpa isolate Nisqually-1 unplaced genomic scaffold, Pop_tri_v3 scaffold_1033, whole genome shotgun sequence",13511,122,37,52,147,358
"NW_020168265.1 Populus trichocarpa isolate Nisqually-1 unplaced genomic scaffold, Pop_tri_v3 scaffold_1036, whole genome shotgun sequence",13370,120,25,53,114,312
"NW_020168266.1 Populus trichocarpa isolate Nisqually-1 unplaced genomic scaffold, Pop_tri_v3 scaffold_1038, whole genome shotgun sequence",13340,135,15,37,125,312
"NW_020168267.1 Populus trichocarpa isolate Nisqually-1 unplaced genomic scaffold, Pop_tri_v3 scaffold_1040, whole genome shotgun sequence",13319,96,28,66,107,297
"NW_020168268.1 Populus trichocarpa isolate Nisqually-1 unplaced genomic scaffold, Pop_tri_v3 scaffold_1043, whole genome shotgun sequence",13439,92,23,35,141,291
"NW_020168269.1 Populus trichocarpa isolate Nisqually-1 unplaced genomic scaffold, Pop_tri_v3 scaffold_1047, whole genome shotgun sequence",13201,146,25,66,127,364
"NW_020168270.1 Populus trichocarpa isolate Nisqually-1 unplaced genomic scaffold, Pop_tri_v3 scaffold_1057, whole genome shotgun sequence",13075,91,32,58,140,321
"NW_020168271.1 Populus trichocarpa isolate Nisqually-1 unplaced genomic scaffold, Pop_tri_v3 scaffold_1058, whole genome shotgun sequence",14283,59,27,38,100,224
"NW_020168272.1 Populus trichocarpa isolate Nisqually-1 unplaced genomic scaffold, Pop_tri_v3 scaffold_1062, whole genome shotgun sequence",13047,26,5,7,19,57
"NW_020168273.1 Populus trichocarpa isolate Nisqually-1 unplaced genomic scaffold, Pop_tri_v3 scaffold_1070, whole genome shotgun sequence",13437,39,36,23,68,166
"NW_020168274.1 Populus trichocarpa isolate Nisqually-1 unplaced genomic scaffold, Pop_tri_v3 scaffold_1076, whole genome shotgun sequence",12983,88,23,36,123,270
"NW_020168275.1 Populus trichocarpa isolate Nisqually-1 unplaced genomic scaffold, Pop_tri_v3 scaffold_1084, whole genome shotgun sequence",13173,80,22,57,106,265
"NW_020168276.1 Populus trichocarpa isolate Nisqually-1 unplaced genomic scaffold, Pop_tri_v3 scaffold_1089, whole genome shotgun sequence",12682,88,48,61,132,329
"NW_020168277.1 Populus trichocarpa isolate Nisqually-1 unplaced genomic scaffold, Pop_tri_v3 scaffold_1090, whole genome shotgun sequence",16452,44,19,29,56,148
"NW_020168278.1 Populus trichocarpa isolate Nisqually-1 unplaced genomic scaffold, Pop_tri_v3 scaffold_1096, whole genome shotgun sequence",12478,121,13,37,122,293
"NW_020168279.1 Populus trichocarpa isolate Nisqually-1 unplaced genomic scaffold, Pop_tri_v3 scaffold_1102, whole genome shotgun sequence",12493,132,35,85,153,405
"NW_020168280.1 Populus trichocarpa isolate Nisqually-1 unplaced genomic scaffold, Pop_tri_v3 scaffold_1103, whole genome shotgun sequence",12560,11,0,9,22,42
"NW_020168281.1 Populus trichocarpa isolate Nisqually-1 unplaced genomic scaffold, Pop_tri_v3 scaffold_1106, whole genome shotgun sequence",12825,92,12,34,100,238
"NW_020168282.1 Populus trichocarpa isolate Nisqually-1 unplaced genomic scaffold, Pop_tri_v3 scaffold_1114, whole genome shotgun sequence",12399,114,29,56,127,326
"NW_020168283.1 Populus trichocarpa isolate Nisqually-1 unplaced genomic scaffold, Pop_tri_v3 scaffold_1117, whole genome shotgun sequence",83378,0,11,0,7,18
"NW_020168284.1 Populus trichocarpa isolate Nisqually-1 unplaced genomic scaffold, Pop_tri_v3 scaffold_1123, whole genome shotgun sequence",12196,56,27,25,85,193
"NW_020168285.1 Populus trichocarpa isolate Nisqually-1 unplaced genomic scaffold, Pop_tri_v3 scaffold_1129, whole genome shotgun sequence",12343,52,18,29,64,163
"NW_020168286.1 Populus trichocarpa isolate Nisqually-1 unplaced genomic scaffold, Pop_tri_v3 scaffold_1132, whole genome shotgun sequence",12046,81,33,38,121,273
"NW_020168287.1 Populus trichocarpa isolate Nisqually-1 unplaced genomic scaffold, Pop_tri_v3 scaffold_1133, whole genome shotgun sequence",12034,87,32,56,110,285
"NW_020168288.1 Populus trichocarpa isolate Nisqually-1 unplaced genomic scaffold, Pop_tri_v3 scaffold_1134, whole genome shotgun sequence",12138,101,43,56,158,358
"NW_020168289.1 Populus trichocarpa isolate Nisqually-1 unplaced genomic scaffold, Pop_tri_v3 scaffold_1136, whole genome shotgun sequence",15398,10,1,13,4,28
"NW_020168290.1 Populus trichocarpa isolate Nisqually-1 unplaced genomic scaffold, Pop_tri_v3 scaffold_1140, whole genome shotgun sequence",41427,11,3,8,5,27
"NW_020168291.1 Populus trichocarpa isolate Nisqually-1 unplaced genomic scaffold, Pop_tri_v3 scaffold_1144, whole genome shotgun sequence",11925,117,35,37,119,308
"NW_020168292.1 Populus trichocarpa isolate Nisqually-1 unplaced genomic scaffold, Pop_tri_v3 scaffold_1145, whole genome shotgun sequence",11924,42,25,19,50,136
"NW_020168293.1 Populus trichocarpa isolate Nisqually-1 unplaced genomic scaffold, Pop_tri_v3 scaffold_1150, whole genome shotgun sequence",12437,123,26,64,100,313
"NW_020168294.1 Populus trichocarpa isolate Nisqually-1 unplaced genomic scaffold, Pop_tri_v3 scaffold_1153, whole genome shotgun sequence",13338,118,50,55,164,387
"NW_020168295.1 Populus trichocarpa isolate Nisqually-1 unplaced genomic scaffold, Pop_tri_v3 scaffold_1158, whole genome shotgun sequence",11798,120,27,57,111,315
"NW_020168296.1 Populus trichocarpa isolate Nisqually-1 unplaced genomic scaffold, Pop_tri_v3 scaffold_1162, whole genome shotgun sequence",11758,140,24,56,131,351
"NW_020168297.1 Populus trichocarpa isolate Nisqually-1 unplaced genomic scaffold, Pop_tri_v3 scaffold_1163, whole genome shotgun sequence",11966,86,24,33,117,260
"NW_020168298.1 Populus trichocarpa isolate Nisqually-1 unplaced genomic scaffold, Pop_tri_v3 scaffold_1170, whole genome shotgun sequence",11622,84,27,49,83,243
"NW_020168299.1 Populus trichocarpa isolate Nisqually-1 unplaced genomic scaffold, Pop_tri_v3 scaffold_1171, whole genome shotgun sequence",12411,88,31,44,133,296
"NW_020168300.1 Populus trichocarpa isolate Nisqually-1 unplaced genomic scaffold, Pop_tri_v3 scaffold_1173, whole genome shotgun sequence",11575,19,9,6,41,75
"NW_020168301.1 Populus trichocarpa isolate Nisqually-1 unplaced genomic scaffold, Pop_tri_v3 scaffold_1179, whole genome shotgun sequence",11509,110,32,55,124,321
"NW_020168302.1 Populus trichocarpa isolate Nisqually-1 unplaced genomic scaffold, Pop_tri_v3 scaffold_1180, whole genome shotgun sequence",11504,57,37,31,78,203
"NW_020168303.1 Populus trichocarpa isolate Nisqually-1 unplaced genomic scaffold, Pop_tri_v3 scaffold_1181, whole genome shotgun sequence",11499,76,42,46,108,272
"NW_020168304.1 Populus trichocarpa isolate Nisqually-1 unplaced genomic scaffold, Pop_tri_v3 scaffold_1183, whole genome shotgun sequence",11587,32,6,13,36,87
"NW_020168305.1 Populus trichocarpa isolate Nisqually-1 unplaced genomic scaffold, Pop_tri_v3 scaffold_1184, whole genome shotgun sequence",11937,53,18,26,56,153
"NW_020168306.1 Populus trichocarpa isolate Nisqually-1 unplaced genomic scaffold, Pop_tri_v3 scaffold_1193, whole genome shotgun sequence",14586,51,31,14,52,148
"NW_020168307.1 Populus trichocarpa isolate Nisqually-1 unplaced genomic scaffold, Pop_tri_v3 scaffold_1195, whole genome shotgun sequence",44540,12,4,0,21,37
"NW_020168308.1 Populus trichocarpa isolate Nisqually-1 unplaced genomic scaffold, Pop_tri_v3 scaffold_1196, whole genome shotgun sequence",11859,79,19,33,109,240
"NW_020168309.1 Populus trichocarpa isolate Nisqually-1 unplaced genomic scaffold, Pop_tri_v3 scaffold_1197, whole genome shotgun sequence",11367,83,29,44,123,279
"NW_020168310.1 Populus trichocarpa isolate Nisqually-1 unplaced genomic scaffold, Pop_tri_v3 scaffold_1198, whole genome shotgun sequence",11515,93,14,53,107,267
"NW_020168311.1 Populus trichocarpa isolate Nisqually-1 unplaced genomic scaffold, Pop_tri_v3 scaffold_1199, whole genome shotgun sequence",11601,47,25,18,47,137
"NW_020168312.1 Populus trichocarpa isolate Nisqually-1 unplaced genomic scaffold, Pop_tri_v3 scaffold_1200, whole genome shotgun sequence",11244,105,34,42,75,256
"NW_020168313.1 Populus trichocarpa isolate Nisqually-1 unplaced genomic scaffold, Pop_tri_v3 scaffold_1203, whole genome shotgun sequence",11635,56,23,34,80,193
"NW_020168314.1 Populus trichocarpa isolate Nisqually-1 unplaced genomic scaffold, Pop_tri_v3 scaffold_1204, whole genome shotgun sequence",11706,50,18,21,58,147
"NW_020168315.1 Populus trichocarpa isolate Nisqually-1 unplaced genomic scaffold, Pop_tri_v3 scaffold_1205, whole genome shotgun sequence",11219,72,41,43,84,240
"NW_020168316.1 Populus trichocarpa isolate Nisqually-1 unplaced genomic scaffold, Pop_tri_v3 scaffold_1208, whole genome shotgun sequence",11208,88,30,46,106,270
"NW_020168317.1 Populus trichocarpa isolate Nisqually-1 unplaced genomic scaffold, Pop_tri_v3 scaffold_1211, whole genome shotgun sequence",11527,73,19,36,72,200
"NW_020168318.1 Populus trichocarpa isolate Nisqually-1 unplaced genomic scaffold, Pop_tri_v3 scaffold_1213, whole genome shotgun sequence",11155,107,39,56,95,297
"NW_020168319.1 Populus trichocarpa isolate Nisqually-1 unplaced genomic scaffold, Pop_tri_v3 scaffold_1214, whole genome shotgun sequence",12423,104,35,57,134,330
"NW_020168320.1 Populus trichocarpa isolate Nisqually-1 unplaced genomic scaffold, Pop_tri_v3 scaffold_1228, whole genome shotgun sequence",10985,91,32,40,106,269
"NW_020168321.1 Populus trichocarpa isolate Nisqually-1 unplaced genomic scaffold, Pop_tri_v3 scaffold_1233, whole genome shotgun sequence",10897,66,26,30,74,196
"NW_020168322.1 Populus trichocarpa isolate Nisqually-1 unplaced genomic scaffold, Pop_tri_v3 scaffold_1236, whole genome shotgun sequence",10821,139,35,60,120,354
"NW_020168323.1 Populus trichocarpa isolate Nisqually-1 unplaced genomic scaffold, Pop_tri_v3 scaffold_1238, whole genome shotgun sequence",10787,69,17,35,78,199
"NW_020168324.1 Populus trichocarpa isolate Nisqually-1 unplaced genomic scaffold, Pop_tri_v3 scaffold_1241, whole genome shotgun sequence",10698,77,15,40,102,234
"NW_020168325.1 Populus trichocarpa isolate Nisqually-1 unplaced genomic scaffold, Pop_tri_v3 scaffold_1243, whole genome shotgun sequence",10791,70,25,40,100,235
"NW_020168326.1 Populus trichocarpa isolate Nisqually-1 unplaced genomic scaffold, Pop_tri_v3 scaffold_1244, whole genome shotgun sequence",10778,13,19,9,29,70
"NW_020168327.1 Populus trichocarpa isolate Nisqually-1 unplaced genomic scaffold, Pop_tri_v3 scaffold_1247, whole genome shotgun sequence",10659,64,14,28,68,174
"NW_020168328.1 Populus trichocarpa isolate Nisqually-1 unplaced genomic scaffold, Pop_tri_v3 scaffold_1250, whole genome shotgun sequence",10649,80,33,46,115,274
"NW_020168329.1 Populus trichocarpa isolate Nisqually-1 unplaced genomic scaffold, Pop_tri_v3 scaffold_1264, whole genome shotgun sequence",10456,113,26,50,115,304
"NW_020168330.1 Populus trichocarpa isolate Nisqually-1 unplaced genomic scaffold, Pop_tri_v3 scaffold_1265, whole genome shotgun sequence",10626,70,40,58,43,211
"NW_020168331.1 Populus trichocarpa isolate Nisqually-1 unplaced genomic scaffold, Pop_tri_v3 scaffold_1269, whole genome shotgun sequence",12040,12,7,2,2,23
"NW_020168332.1 Populus trichocarpa isolate Nisqually-1 unplaced genomic scaffold, Pop_tri_v3 scaffold_1271, whole genome shotgun sequence",12933,36,19,20,9,84
"NW_020168333.1 Populus trichocarpa isolate Nisqually-1 unplaced genomic scaffold, Pop_tri_v3 scaffold_1272, whole genome shotgun sequence",10374,89,23,32,72,216
"NW_020168334.1 Populus trichocarpa isolate Nisqually-1 unplaced genomic scaffold, Pop_tri_v3 scaffold_1275, whole genome shotgun sequence",10367,67,22,34,97,220
"NW_020168335.1 Populus trichocarpa isolate Nisqually-1 unplaced genomic scaffold, Pop_tri_v3 scaffold_1280, whole genome shotgun sequence",10401,19,11,8,39,77
"NW_020168336.1 Populus trichocarpa isolate Nisqually-1 unplaced genomic scaffold, Pop_tri_v3 scaffold_1282, whole genome shotgun sequence",10912,103,21,48,87,259
"NW_020168337.1 Populus trichocarpa isolate Nisqually-1 unplaced genomic scaffold, Pop_tri_v3 scaffold_1284, whole genome shotgun sequence",10394,78,28,39,109,254
"NW_020168338.1 Populus trichocarpa isolate Nisqually-1 unplaced genomic scaffold, Pop_tri_v3 scaffold_1286, whole genome shotgun sequence",10282,103,20,44,144,311
"NW_020168339.1 Populus trichocarpa isolate Nisqually-1 unplaced genomic scaffold, Pop_tri_v3 scaffold_1291, whole genome shotgun sequence",10250,84,17,29,89,219
"NW_020168340.1 Populus trichocarpa isolate Nisqually-1 unplaced genomic scaffold, Pop_tri_v3 scaffold_1292, whole genome shotgun sequence",10236,22,19,20,35,96
"NW_020168341.1 Populus trichocarpa isolate Nisqually-1 unplaced genomic scaffold, Pop_tri_v3 scaffold_1295, whole genome shotgun sequence",10216,66,17,28,87,198
"NW_020168342.1 Populus trichocarpa isolate Nisqually-1 unplaced genomic scaffold, Pop_tri_v3 scaffold_1296, whole genome shotgun sequence",10201,104,21,47,128,300
"NW_020168343.1 Populus trichocarpa isolate Nisqually-1 unplaced genomic scaffold, Pop_tri_v3 scaffold_1299, whole genome shotgun sequence",10183,67,21,45,67,200
"NW_020168344.1 Populus trichocarpa isolate Nisqually-1 unplaced genomic scaffold, Pop_tri_v3 scaffold_1301, whole genome shotgun sequence",10169,46,23,30,57,156
"NW_020168345.1 Populus trichocarpa isolate Nisqually-1 unplaced genomic scaffold, Pop_tri_v3 scaffold_1304, whole genome shotgun sequence",10603,67,17,41,99,224
"NW_020168346.1 Populus trichocarpa isolate Nisqually-1 unplaced genomic scaffold, Pop_tri_v3 scaffold_1309, whole genome shotgun sequence",10218,71,13,34,87,205
"NW_020168347.1 Populus trichocarpa isolate Nisqually-1 unplaced genomic scaffold, Pop_tri_v3 scaffold_1311, whole genome shotgun sequence",10104,81,8,34,87,210
"NW_020168348.1 Populus trichocarpa isolate Nisqually-1 unplaced genomic scaffold, Pop_tri_v3 scaffold_1312, whole genome shotgun sequence",10094,49,24,32,65,170
"NW_020168349.1 Populus trichocarpa isolate Nisqually-1 unplaced genomic scaffold, Pop_tri_v3 scaffold_1315, whole genome shotgun sequence",41809,16,6,31,32,85
"NW_020168350.1 Populus trichocarpa isolate Nisqually-1 unplaced genomic scaffold, Pop_tri_v3 scaffold_1316, whole genome shotgun sequence",10200,93,19,39,100,251
"NW_020168351.1 Populus trichocarpa isolate Nisqually-1 unplaced genomic scaffold, Pop_tri_v3 scaffold_1324, whole genome shotgun sequence",11324,18,13,6,20,57
"NW_020168352.1 Populus trichocarpa isolate Nisqually-1 unplaced genomic scaffold, Pop_tri_v3 scaffold_1325, whole genome shotgun sequence",10369,79,23,37,88,227
"NW_020168353.1 Populus trichocarpa isolate Nisqually-1 unplaced genomic scaffold, Pop_tri_v3 scaffold_1326, whole genome shotgun sequence",10139,83,30,57,89,259
"NW_020168354.1 Populus trichocarpa isolate Nisqually-1 unplaced genomic scaffold, Pop_tri_v3 scaffold_1331, whole genome shotgun sequence",11101,24,30,14,19,87
"NW_020168355.1 Populus trichocarpa isolate Nisqually-1 unplaced genomic scaffold, Pop_tri_v3 scaffold_1334, whole genome shotgun sequence",9899,69,31,42,94,236
"NW_020168356.1 Populus trichocarpa isolate Nisqually-1 unplaced genomic scaffold, Pop_tri_v3 scaffold_1337, whole genome shotgun sequence",10135,91,16,55,141,303
"NW_020168357.1 Populus trichocarpa isolate Nisqually-1 unplaced genomic scaffold, Pop_tri_v3 scaffold_1340, whole genome shotgun sequence",9946,77,33,43,82,235
"NW_020168358.1 Populus trichocarpa isolate Nisqually-1 unplaced genomic scaffold, Pop_tri_v3 scaffold_1341, whole genome shotgun sequence",10090,100,26,56,120,302
"NW_020168359.1 Populus trichocarpa isolate Nisqually-1 unplaced genomic scaffold, Pop_tri_v3 scaffold_1344, whole genome shotgun sequence",10936,13,19,7,17,56
"NW_020168360.1 Populus trichocarpa isolate Nisqually-1 unplaced genomic scaffold, Pop_tri_v3 scaffold_1352, whole genome shotgun sequence",10075,68,18,25,77,188
"NW_020168361.1 Populus trichocarpa isolate Nisqually-1 unplaced genomic scaffold, Pop_tri_v3 scaffold_1353, whole genome shotgun sequence",9878,80,32,37,123,272
"NW_020168362.1 Populus trichocarpa isolate Nisqually-1 unplaced genomic scaffold, Pop_tri_v3 scaffold_1363, whole genome shotgun sequence",10321,60,43,29,74,206
"NW_020168363.1 Populus trichocarpa isolate Nisqually-1 unplaced genomic scaffold, Pop_tri_v3 scaffold_1366, whole genome shotgun sequence",9706,72,33,52,102,259
"NW_020168364.1 Populus trichocarpa isolate Nisqually-1 unplaced genomic scaffold, Pop_tri_v3 scaffold_1370, whole genome shotgun sequence",10409,7,6,10,14,37
"NW_020168365.1 Populus trichocarpa isolate Nisqually-1 unplaced genomic scaffold, Pop_tri_v3 scaffold_1372, whole genome shotgun sequence",10189,55,9,20,58,142
"NW_020168366.1 Populus trichocarpa isolate Nisqually-1 unplaced genomic scaffold, Pop_tri_v3 scaffold_1377, whole genome shotgun sequence",9694,95,15,37,95,242
"NW_020168367.1 Populus trichocarpa isolate Nisqually-1 unplaced genomic scaffold, Pop_tri_v3 scaffold_1378, whole genome shotgun sequence",9943,63,21,31,97,212
"NW_020168368.1 Populus trichocarpa isolate Nisqually-1 unplaced genomic scaffold, Pop_tri_v3 scaffold_1382, whole genome shotgun sequence",9642,66,27,17,72,182
"NW_020168369.1 Populus trichocarpa isolate Nisqually-1 unplaced genomic scaffold, Pop_tri_v3 scaffold_1383, whole genome shotgun sequence",9878,48,20,26,74,168
"NW_020168370.1 Populus trichocarpa isolate Nisqually-1 unplaced genomic scaffold, Pop_tri_v3 scaffold_1390, whole genome shotgun sequence",10143,30,17,20,40,107
"NW_020168371.1 Populus trichocarpa isolate Nisqually-1 unplaced genomic scaffold, Pop_tri_v3 scaffold_1391, whole genome shotgun sequence",9475,33,13,22,38,106
"NW_020168372.1 Populus trichocarpa isolate Nisqually-1 unplaced genomic scaffold, Pop_tri_v3 scaffold_1396, whole genome shotgun sequence",12766,7,5,2,2,16
"NW_020168373.1 Populus trichocarpa isolate Nisqually-1 unplaced genomic scaffold, Pop_tri_v3 scaffold_1397, whole genome shotgun sequence",10331,15,8,14,6,43
"NW_020168374.1 Populus trichocarpa isolate Nisqually-1 unplaced genomic scaffold, Pop_tri_v3 scaffold_1398, whole genome shotgun sequence",9400,64,20,27,79,190
"NW_020168375.1 Populus trichocarpa isolate Nisqually-1 unplaced genomic scaffold, Pop_tri_v3 scaffold_1399, whole genome shotgun sequence",9590,84,45,39,93,261
"NW_020168376.1 Populus trichocarpa isolate Nisqually-1 unplaced genomic scaffold, Pop_tri_v3 scaffold_1402, whole genome shotgun sequence",9486,85,45,56,147,333
"NW_020168377.1 Populus trichocarpa isolate Nisqually-1 unplaced genomic scaffold, Pop_tri_v3 scaffold_1403, whole genome shotgun sequence",9583,31,4,17,39,91
"NW_020168378.1 Populus trichocarpa isolate Nisqually-1 unplaced genomic scaffold, Pop_tri_v3 scaffold_1405, whole genome shotgun sequence",9352,79,28,51,78,236
"NW_020168379.1 Populus trichocarpa isolate Nisqually-1 unplaced genomic scaffold, Pop_tri_v3 scaffold_1412, whole genome shotgun sequence",9488,50,22,33,72,177
"NW_020168380.1 Populus trichocarpa isolate Nisqually-1 unplaced genomic scaffold, Pop_tri_v3 scaffold_1415, whole genome shotgun sequence",10032,49,11,21,54,135
"NW_020168381.1 Populus trichocarpa isolate Nisqually-1 unplaced genomic scaffold, Pop_tri_v3 scaffold_1417, whole genome shotgun sequence",9821,54,10,25,48,137
"NW_020168382.1 Populus trichocarpa isolate Nisqually-1 unplaced genomic scaffold, Pop_tri_v3 scaffold_1418, whole genome shotgun sequence",9463,37,12,29,50,128
"NW_020168383.1 Populus trichocarpa isolate Nisqually-1 unplaced genomic scaffold, Pop_tri_v3 scaffold_1419, whole genome shotgun sequence",9722,58,18,33,73,182
"NW_020168384.1 Populus trichocarpa isolate Nisqually-1 unplaced genomic scaffold, Pop_tri_v3 scaffold_1422, whole genome shotgun sequence",9191,52,11,15,53,131
"NW_020168385.1 Populus trichocarpa isolate Nisqually-1 unplaced genomic scaffold, Pop_tri_v3 scaffold_1423, whole genome shotgun sequence",12773,3,13,4,1,21
"NW_020168386.1 Populus trichocarpa isolate Nisqually-1 unplaced genomic scaffold, Pop_tri_v3 scaffold_1425, whole genome shotgun sequence",9839,144,28,58,106,336
"NW_020168387.1 Populus trichocarpa isolate Nisqually-1 unplaced genomic scaffold, Pop_tri_v3 scaffold_1426, whole genome shotgun sequence",9165,71,26,32,84,213
"NW_020168388.1 Populus trichocarpa isolate Nisqually-1 unplaced genomic scaffold, Pop_tri_v3 scaffold_1429, whole genome shotgun sequence",10041,72,36,42,106,256
"NW_020168389.1 Populus trichocarpa isolate Nisqually-1 unplaced genomic scaffold, Pop_tri_v3 scaffold_1430, whole genome shotgun sequence",45911,8,4,16,16,44
"NW_020168390.1 Populus trichocarpa isolate Nisqually-1 unplaced genomic scaffold, Pop_tri_v3 scaffold_1434, whole genome shotgun sequence",129420,0,6,0,4,10
"NW_020168391.1 Populus trichocarpa isolate Nisqually-1 unplaced genomic scaffold, Pop_tri_v3 scaffold_1435, whole genome shotgun sequence",10097,72,28,41,101,242
"NW_020168392.1 Populus trichocarpa isolate Nisqually-1 unplaced genomic scaffold, Pop_tri_v3 scaffold_1437, whole genome shotgun sequence",9061,64,26,46,77,213
"NW_020168393.1 Populus trichocarpa isolate Nisqually-1 unplaced genomic scaffold, Pop_tri_v3 scaffold_1438, whole genome shotgun sequence",9148,11,2,8,23,44
"NW_020168394.1 Populus trichocarpa isolate Nisqually-1 unplaced genomic scaffold, Pop_tri_v3 scaffold_1441, whole genome shotgun sequence",9036,37,19,22,56,134
"NW_020168395.1 Populus trichocarpa isolate Nisqually-1 unplaced genomic scaffold, Pop_tri_v3 scaffold_1443, whole genome shotgun sequence",9291,69,26,34,73,202
"NW_020168396.1 Populus trichocarpa isolate Nisqually-1 unplaced genomic scaffold, Pop_tri_v3 scaffold_1446, whole genome shotgun sequence",8983,87,15,35,75,212
"NW_020168397.1 Populus trichocarpa isolate Nisqually-1 unplaced genomic scaffold, Pop_tri_v3 scaffold_1447, whole genome shotgun sequence",9658,33,18,13,49,113
"NW_020168398.1 Populus trichocarpa isolate Nisqually-1 unplaced genomic scaffold, Pop_tri_v3 scaffold_1451, whole genome shotgun sequence",8926,55,13,24,63,155
"NW_020168399.1 Populus trichocarpa isolate Nisqually-1 unplaced genomic scaffold, Pop_tri_v3 scaffold_1458, whole genome shotgun sequence",8876,79,22,29,82,212
"NW_020168400.1 Populus trichocarpa isolate Nisqually-1 unplaced genomic scaffold, Pop_tri_v3 scaffold_1459, whole genome shotgun sequence",12741,42,23,21,62,148
"NW_020168401.1 Populus trichocarpa isolate Nisqually-1 unplaced genomic scaffold, Pop_tri_v3 scaffold_1462, whole genome shotgun sequence",8789,67,40,36,81,224
"NW_020168402.1 Populus trichocarpa isolate Nisqually-1 unplaced genomic scaffold, Pop_tri_v3 scaffold_1463, whole genome shotgun sequence",8785,75,20,32,83,210
"NW_020168403.1 Populus trichocarpa isolate Nisqually-1 unplaced genomic scaffold, Pop_tri_v3 scaffold_1464, whole genome shotgun sequence",9134,48,17,36,78,179
"NW_020168404.1 Populus trichocarpa isolate Nisqually-1 unplaced genomic scaffold, Pop_tri_v3 scaffold_1467, whole genome shotgun sequence",8813,86,13,44,136,279
"NW_020168405.1 Populus trichocarpa isolate Nisqually-1 unplaced genomic scaffold, Pop_tri_v3 scaffold_1470, whole genome shotgun sequence",8685,52,16,25,78,171
"NW_020168406.1 Populus trichocarpa isolate Nisqually-1 unplaced genomic scaffold, Pop_tri_v3 scaffold_1474, whole genome shotgun sequence",41081,16,9,4,7,36
"NW_020168407.1 Populus trichocarpa isolate Nisqually-1 unplaced genomic scaffold, Pop_tri_v3 scaffold_1475, whole genome shotgun sequence",8630,47,21,26,49,143
"NW_020168408.1 Populus trichocarpa isolate Nisqually-1 unplaced genomic scaffold, Pop_tri_v3 scaffold_1477, whole genome shotgun sequence",8725,66,13,44,86,209
"NW_020168409.1 Populus trichocarpa isolate Nisqually-1 unplaced genomic scaffold, Pop_tri_v3 scaffold_1478, whole genome shotgun sequence",9034,85,43,51,114,293
"NW_020168410.1 Populus trichocarpa isolate Nisqually-1 unplaced genomic scaffold, Pop_tri_v3 scaffold_1479, whole genome shotgun sequence",8703,22,29,15,39,105
"NW_020168411.1 Populus trichocarpa isolate Nisqually-1 unplaced genomic scaffold, Pop_tri_v3 scaffold_1480, whole genome shotgun sequence",8597,16,3,5,12,36
"NW_020168412.1 Populus trichocarpa isolate Nisqually-1 unplaced genomic scaffold, Pop_tri_v3 scaffold_1484, whole genome shotgun sequence",8547,123,25,85,164,397
"NW_020168413.1 Populus trichocarpa isolate Nisqually-1 unplaced genomic scaffold, Pop_tri_v3 scaffold_1485, whole genome shotgun sequence",10504,16,72,30,12,130
"NW_020168414.1 Populus trichocarpa isolate Nisqually-1 unplaced genomic scaffold, Pop_tri_v3 scaffold_1488, whole genome shotgun sequence",8656,62,16,42,88,208
"NW_020168415.1 Populus trichocarpa isolate Nisqually-1 unplaced genomic scaffold, Pop_tri_v3 scaffold_1491, whole genome shotgun sequence",8472,39,16,16,38,109
"NW_020168416.1 Populus trichocarpa isolate Nisqually-1 unplaced genomic scaffold, Pop_tri_v3 scaffold_1496, whole genome shotgun sequence",9360,52,20,29,62,163
"NW_020168417.1 Populus trichocarpa isolate Nisqually-1 unplaced genomic scaffold, Pop_tri_v3 scaffold_1497, whole genome shotgun sequence",8405,91,14,54,138,297
"NW_020168418.1 Populus trichocarpa isolate Nisqually-1 unplaced genomic scaffold, Pop_tri_v3 scaffold_1502, whole genome shotgun sequence",8351,33,24,15,53,125
"NW_020168419.1 Populus trichocarpa isolate Nisqually-1 unplaced genomic scaffold, Pop_tri_v3 scaffold_1506, whole genome shotgun sequence",8292,11,18,9,8,46
"NW_020168420.1 Populus trichocarpa isolate Nisqually-1 unplaced genomic scaffold, Pop_tri_v3 scaffold_1508, whole genome shotgun sequence",9297,29,13,17,41,100
"NW_020168421.1 Populus trichocarpa isolate Nisqually-1 unplaced genomic scaffold, Pop_tri_v3 scaffold_1509, whole genome shotgun sequence",8257,80,17,42,69,208
"NW_020168422.1 Populus trichocarpa isolate Nisqually-1 unplaced genomic scaffold, Pop_tri_v3 scaffold_1514, whole genome shotgun sequence",8323,127,32,72,148,379
"NW_020168423.1 Populus trichocarpa isolate Nisqually-1 unplaced genomic scaffold, Pop_tri_v3 scaffold_1515, whole genome shotgun sequence",8209,44,18,23,87,172
"NW_020168424.1 Populus trichocarpa isolate Nisqually-1 unplaced genomic scaffold, Pop_tri_v3 scaffold_1517, whole genome shotgun sequence",9666,8,4,2,7,21
"NW_020168425.1 Populus trichocarpa isolate Nisqually-1 unplaced genomic scaffold, Pop_tri_v3 scaffold_1520, whole genome shotgun sequence",8972,86,31,48,121,286
"NW_020168426.1 Populus trichocarpa isolate Nisqually-1 unplaced genomic scaffold, Pop_tri_v3 scaffold_1521, whole genome shotgun sequence",8523,41,17,19,65,142
"NW_020168427.1 Populus trichocarpa isolate Nisqually-1 unplaced genomic scaffold, Pop_tri_v3 scaffold_1525, whole genome shotgun sequence",8139,29,12,23,60,124
"NW_020168428.1 Populus trichocarpa isolate Nisqually-1 unplaced genomic scaffold, Pop_tri_v3 scaffold_1527, whole genome shotgun sequence",10975,24,13,43,27,107
"NW_020168429.1 Populus trichocarpa isolate Nisqually-1 unplaced genomic scaffold, Pop_tri_v3 scaffold_1530, whole genome shotgun sequence",8102,102,28,52,136,318
"NW_020168430.1 Populus trichocarpa isolate Nisqually-1 unplaced genomic scaffold, Pop_tri_v3 scaffold_1534, whole genome shotgun sequence",8078,57,14,24,53,148
"NW_020168431.1 Populus trichocarpa isolate Nisqually-1 unplaced genomic scaffold, Pop_tri_v3 scaffold_1540, whole genome shotgun sequence",8042,65,18,38,98,219
"NW_020168432.1 Populus trichocarpa isolate Nisqually-1 unplaced genomic scaffold, Pop_tri_v3 scaffold_1541, whole genome shotgun sequence",8523,48,25,31,62,166
"NW_020168433.1 Populus trichocarpa isolate Nisqually-1 unplaced genomic scaffold, Pop_tri_v3 scaffold_1542, whole genome shotgun sequence",8029,50,16,34,50,150
"NW_020168434.1 Populus trichocarpa isolate Nisqually-1 unplaced genomic scaffold, Pop_tri_v3 scaffold_1543, whole genome shotgun sequence",8238,44,13,25,69,151
"NW_020168435.1 Populus trichocarpa isolate Nisqually-1 unplaced genomic scaffold, Pop_tri_v3 scaffold_1546, whole genome shotgun sequence",7965,43,20,29,66,158
"NW_020168436.1 Populus trichocarpa isolate Nisqually-1 unplaced genomic scaffold, Pop_tri_v3 scaffold_1548, whole genome shotgun sequence",7952,29,11,28,33,101
"NW_020168437.1 Populus trichocarpa isolate Nisqually-1 unplaced genomic scaffold, Pop_tri_v3 scaffold_1551, whole genome shotgun sequence",8260,66,21,28,90,205
"NW_020168438.1 Populus trichocarpa isolate Nisqually-1 unplaced genomic scaffold, Pop_tri_v3 scaffold_1553, whole genome shotgun sequence",7913,46,24,28,57,155
"NW_020168439.1 Populus trichocarpa isolate Nisqually-1 unplaced genomic scaffold, Pop_tri_v3 scaffold_1555, whole genome shotgun sequence",9101,6,8,5,9,28
"NW_020168440.1 Populus trichocarpa isolate Nisqually-1 unplaced genomic scaffold, Pop_tri_v3 scaffold_1557, whole genome shotgun sequence",7901,61,22,31,86,200
"NW_020168441.1 Populus trichocarpa isolate Nisqually-1 unplaced genomic scaffold, Pop_tri_v3 scaffold_1558, whole genome shotgun sequence",9159,56,9,23,56,144
"NW_020168442.1 Populus trichocarpa isolate Nisqually-1 unplaced genomic scaffold, Pop_tri_v3 scaffold_1561, whole genome shotgun sequence",7888,68,11,31,80,190
"NW_020168443.1 Populus trichocarpa isolate Nisqually-1 unplaced genomic scaffold, Pop_tri_v3 scaffold_1563, whole genome shotgun sequence",8379,20,14,5,54,93
"NW_020168444.1 Populus trichocarpa isolate Nisqually-1 unplaced genomic scaffold, Pop_tri_v3 scaffold_1568, whole genome shotgun sequence",8295,51,27,39,61,178
"NW_020168445.1 Populus trichocarpa isolate Nisqually-1 unplaced genomic scaffold, Pop_tri_v3 scaffold_1571, whole genome shotgun sequence",8247,54,16,24,47,141
"NW_020168446.1 Populus trichocarpa isolate Nisqually-1 unplaced genomic scaffold, Pop_tri_v3 scaffold_1578, whole genome shotgun sequence",39901,7,5,5,10,27
"NW_020168447.1 Populus trichocarpa isolate Nisqually-1 unplaced genomic scaffold, Pop_tri_v3 scaffold_1580, whole genome shotgun sequence",8245,26,25,19,38,108
"NW_020168448.1 Populus trichocarpa isolate Nisqually-1 unplaced genomic scaffold, Pop_tri_v3 scaffold_1581, whole genome shotgun sequence",7708,70,23,46,99,238
"NW_020168449.1 Populus trichocarpa isolate Nisqually-1 unplaced genomic scaffold, Pop_tri_v3 scaffold_1585, whole genome shotgun sequence",7666,28,13,12,38,91
"NW_020168450.1 Populus trichocarpa isolate Nisqually-1 unplaced genomic scaffold, Pop_tri_v3 scaffold_1586, whole genome shotgun sequence",7961,63,39,28,74,204
"NW_020168451.1 Populus trichocarpa isolate Nisqually-1 unplaced genomic scaffold, Pop_tri_v3 scaffold_1591, whole genome shotgun sequence",7800,67,15,38,72,192
"NW_020168452.1 Populus trichocarpa isolate Nisqually-1 unplaced genomic scaffold, Pop_tri_v3 scaffold_1592, whole genome shotgun sequence",7739,63,14,33,78,188
"NW_020168453.1 Populus trichocarpa isolate Nisqually-1 unplaced genomic scaffold, Pop_tri_v3 scaffold_1594, whole genome shotgun sequence",39920,10,13,6,14,43
"NW_020168454.1 Populus trichocarpa isolate Nisqually-1 unplaced genomic scaffold, Pop_tri_v3 scaffold_1595, whole genome shotgun sequence",7588,39,21,21,62,143
"NW_020168455.1 Populus trichocarpa isolate Nisqually-1 unplaced genomic scaffold, Pop_tri_v3 scaffold_1598, whole genome shotgun sequence",8541,3,2,2,6,13
"NW_020168456.1 Populus trichocarpa isolate Nisqually-1 unplaced genomic scaffold, Pop_tri_v3 scaffold_1601, whole genome shotgun sequence",7656,81,17,28,107,233
"NW_020168457.1 Populus trichocarpa isolate Nisqually-1 unplaced genomic scaffold, Pop_tri_v3 scaffold_1613, whole genome shotgun sequence",7493,78,14,46,128,266
"NW_020168458.1 Populus trichocarpa isolate Nisqually-1 unplaced genomic scaffold, Pop_tri_v3 scaffold_1615, whole genome shotgun sequence",9837,26,23,56,32,137
"NW_020168459.1 Populus trichocarpa isolate Nisqually-1 unplaced genomic scaffold, Pop_tri_v3 scaffold_1621, whole genome shotgun sequence",9509,3,0,2,5,10
"NW_020168460.1 Populus trichocarpa isolate Nisqually-1 unplaced genomic scaffold, Pop_tri_v3 scaffold_1622, whole genome shotgun sequence",7516,51,14,21,61,147
"NW_020168461.1 Populus trichocarpa isolate Nisqually-1 unplaced genomic scaffold, Pop_tri_v3 scaffold_1629, whole genome shotgun sequence",7339,51,15,18,39,123
"NW_020168462.1 Populus trichocarpa isolate Nisqually-1 unplaced genomic scaffold, Pop_tri_v3 scaffold_1630, whole genome shotgun sequence",14991,4,3,4,4,15
"NW_020168463.1 Populus trichocarpa isolate Nisqually-1 unplaced genomic scaffold, Pop_tri_v3 scaffold_1631, whole genome shotgun sequence",7334,77,8,38,92,215
"NW_020168464.1 Populus trichocarpa isolate Nisqually-1 unplaced genomic scaffold, Pop_tri_v3 scaffold_1632, whole genome shotgun sequence",7328,32,17,13,58,120
"NW_020168465.1 Populus trichocarpa isolate Nisqually-1 unplaced genomic scaffold, Pop_tri_v3 scaffold_1633, whole genome shotgun sequence",7611,27,12,14,38,91
"NW_020168466.1 Populus trichocarpa isolate Nisqually-1 unplaced genomic scaffold, Pop_tri_v3 scaffold_1634, whole genome shotgun sequence",8900,73,33,48,122,276
"NW_020168467.1 Populus trichocarpa isolate Nisqually-1 unplaced genomic scaffold, Pop_tri_v3 scaffold_1638, whole genome shotgun sequence",7216,47,7,33,60,147
"NW_020168468.1 Populus trichocarpa isolate Nisqually-1 unplaced genomic scaffold, Pop_tri_v3 scaffold_1642, whole genome shotgun sequence",9831,8,8,3,0,19
"NW_020168469.1 Populus trichocarpa isolate Nisqually-1 unplaced genomic scaffold, Pop_tri_v3 scaffold_1644, whole genome shotgun sequence",7488,46,11,25,74,156
"NW_020168470.1 Populus trichocarpa isolate Nisqually-1 unplaced genomic scaffold, Pop_tri_v3 scaffold_1647, whole genome shotgun sequence",7111,40,12,17,54,123
"NW_020168471.1 Populus trichocarpa isolate Nisqually-1 unplaced genomic scaffold, Pop_tri_v3 scaffold_1649, whole genome shotgun sequence",7109,26,1,7,25,59
"NW_020168472.1 Populus trichocarpa isolate Nisqually-1 unplaced genomic scaffold, Pop_tri_v3 scaffold_1654, whole genome shotgun sequence",7082,72,12,38,62,184
"NW_020168473.1 Populus trichocarpa isolate Nisqually-1 unplaced genomic scaffold, Pop_tri_v3 scaffold_1655, whole genome shotgun sequence",7333,80,21,41,69,211
"NW_020168474.1 Populus trichocarpa isolate Nisqually-1 unplaced genomic scaffold, Pop_tri_v3 scaffold_1658, whole genome shotgun sequence",7241,61,17,26,53,157
"NW_020168475.1 Populus trichocarpa isolate Nisqually-1 unplaced genomic scaffold, Pop_tri_v3 scaffold_1661, whole genome shotgun sequence",7380,46,14,25,63,148
"NW_020168476.1 Populus trichocarpa isolate Nisqually-1 unplaced genomic scaffold, Pop_tri_v3 scaffold_1670, whole genome shotgun sequence",6982,41,10,25,79,155
"NW_020168477.1 Populus trichocarpa isolate Nisqually-1 unplaced genomic scaffold, Pop_tri_v3 scaffold_1671, whole genome shotgun sequence",8227,97,59,58,97,311
"NW_020168478.1 Populus trichocarpa isolate Nisqually-1 unplaced genomic scaffold, Pop_tri_v3 scaffold_1675, whole genome shotgun sequence",15558,5,8,6,9,28
"NW_020168479.1 Populus trichocarpa isolate Nisqually-1 unplaced genomic scaffold, Pop_tri_v3 scaffold_1676, whole genome shotgun sequence",6953,105,13,61,134,313
"NW_020168480.1 Populus trichocarpa isolate Nisqually-1 unplaced genomic scaffold, Pop_tri_v3 scaffold_1677, whole genome shotgun sequence",7925,89,12,44,113,258
"NW_020168481.1 Populus trichocarpa isolate Nisqually-1 unplaced genomic scaffold, Pop_tri_v3 scaffold_1678, whole genome shotgun sequence",6942,46,10,23,51,130
"NW_020168482.1 Populus trichocarpa isolate Nisqually-1 unplaced genomic scaffold, Pop_tri_v3 scaffold_1679, whole genome shotgun sequence",6928,16,15,10,18,59
"NW_020168483.1 Populus trichocarpa isolate Nisqually-1 unplaced genomic scaffold, Pop_tri_v3 scaffold_1683, whole genome shotgun sequence",6868,63,12,32,61,168
"NW_020168484.1 Populus trichocarpa isolate Nisqually-1 unplaced genomic scaffold, Pop_tri_v3 scaffold_1686, whole genome shotgun sequence",7275,81,27,41,110,259
"NW_020168485.1 Populus trichocarpa isolate Nisqually-1 unplaced genomic scaffold, Pop_tri_v3 scaffold_1687, whole genome shotgun sequence",7115,60,21,31,75,187
"NW_020168486.1 Populus trichocarpa isolate Nisqually-1 unplaced genomic scaffold, Pop_tri_v3 scaffold_1689, whole genome shotgun sequence",8296,8,8,9,7,32
"NW_020168487.1 Populus trichocarpa isolate Nisqually-1 unplaced genomic scaffold, Pop_tri_v3 scaffold_1692, whole genome shotgun sequence",7974,10,8,4,6,28
"NW_020168488.1 Populus trichocarpa isolate Nisqually-1 unplaced genomic scaffold, Pop_tri_v3 scaffold_1700, whole genome shotgun sequence",6841,56,8,24,53,141
"NW_020168489.1 Populus trichocarpa isolate Nisqually-1 unplaced genomic scaffold, Pop_tri_v3 scaffold_1702, whole genome shotgun sequence",6724,27,9,18,32,86
"NW_020168490.1 Populus trichocarpa isolate Nisqually-1 unplaced genomic scaffold, Pop_tri_v3 scaffold_1705, whole genome shotgun sequence",6850,32,19,14,31,96
"NW_020168491.1 Populus trichocarpa isolate Nisqually-1 unplaced genomic scaffold, Pop_tri_v3 scaffold_1708, whole genome shotgun sequence",6680,46,10,18,49,123
"NW_020168492.1 Populus trichocarpa isolate Nisqually-1 unplaced genomic scaffold, Pop_tri_v3 scaffold_1710, whole genome shotgun sequence",45049,8,7,4,8,27
"NW_020168493.1 Populus trichocarpa isolate Nisqually-1 unplaced genomic scaffold, Pop_tri_v3 scaffold_1712, whole genome shotgun sequence",6651,50,13,18,50,131
"NW_020168494.1 Populus trichocarpa isolate Nisqually-1 unplaced genomic scaffold, Pop_tri_v3 scaffold_1714, whole genome shotgun sequence",6835,2,3,1,1,7
"NW_020168495.1 Populus trichocarpa isolate Nisqually-1 unplaced genomic scaffold, Pop_tri_v3 scaffold_1718, whole genome shotgun sequence",6596,112,26,53,111,302
"NW_020168496.1 Populus trichocarpa isolate Nisqually-1 unplaced genomic scaffold, Pop_tri_v3 scaffold_1720, whole genome shotgun sequence",6681,46,30,30,50,156
"NW_020168497.1 Populus trichocarpa isolate Nisqually-1 unplaced genomic scaffold, Pop_tri_v3 scaffold_1722, whole genome shotgun sequence",6562,81,17,35,62,195
"NW_020168498.1 Populus trichocarpa isolate Nisqually-1 unplaced genomic scaffold, Pop_tri_v3 scaffold_1726, whole genome shotgun sequence",8012,76,22,44,86,228
"NW_020168499.1 Populus trichocarpa isolate Nisqually-1 unplaced genomic scaffold, Pop_tri_v3 scaffold_1729, whole genome shotgun sequence",6619,33,6,10,27,76
"NW_020168500.1 Populus trichocarpa isolate Nisqually-1 unplaced genomic scaffold, Pop_tri_v3 scaffold_1731, whole genome shotgun sequence",7025,12,0,2,15,29
"NW_020168501.1 Populus trichocarpa isolate Nisqually-1 unplaced genomic scaffold, Pop_tri_v3 scaffold_1736, whole genome shotgun sequence",6641,54,13,22,64,153
"NW_020168502.1 Populus trichocarpa isolate Nisqually-1 unplaced genomic scaffold, Pop_tri_v3 scaffold_1737, whole genome shotgun sequence",6439,48,18,34,64,164
"NW_020168503.1 Populus trichocarpa isolate Nisqually-1 unplaced genomic scaffold, Pop_tri_v3 scaffold_1738, whole genome shotgun sequence",6436,25,7,13,30,75
"NW_020168504.1 Populus trichocarpa isolate Nisqually-1 unplaced genomic scaffold, Pop_tri_v3 scaffold_1739, whole genome shotgun sequence",7027,65,15,39,91,210
"NW_020168505.1 Populus trichocarpa isolate Nisqually-1 unplaced genomic scaffold, Pop_tri_v3 scaffold_1747, whole genome shotgun sequence",6403,34,11,16,38,99
"NW_020168506.1 Populus trichocarpa isolate Nisqually-1 unplaced genomic scaffold, Pop_tri_v3 scaffold_1748, whole genome shotgun sequence",6641,74,24,40,84,222
"NW_020168507.1 Populus trichocarpa isolate Nisqually-1 unplaced genomic scaffold, Pop_tri_v3 scaffold_1750, whole genome shotgun sequence",7480,47,17,24,49,137
"NW_020168508.1 Populus trichocarpa isolate Nisqually-1 unplaced genomic scaffold, Pop_tri_v3 scaffold_1751, whole genome shotgun sequence",6383,48,21,24,54,147
"NW_020168509.1 Populus trichocarpa isolate Nisqually-1 unplaced genomic scaffold, Pop_tri_v3 scaffold_1753, whole genome shotgun sequence",6378,33,16,20,36,105
"NW_020168510.1 Populus trichocarpa isolate Nisqually-1 unplaced genomic scaffold, Pop_tri_v3 scaffold_1764, whole genome shotgun sequence",6411,38,22,13,41,114
"NW_020168511.1 Populus trichocarpa isolate Nisqually-1 unplaced genomic scaffold, Pop_tri_v3 scaffold_1766, whole genome shotgun sequence",6541,30,15,19,45,109
"NW_020168512.1 Populus trichocarpa isolate Nisqually-1 unplaced genomic scaffold, Pop_tri_v3 scaffold_1769, whole genome shotgun sequence",6342,47,11,22,39,119
"NW_020168513.1 Populus trichocarpa isolate Nisqually-1 unplaced genomic scaffold, Pop_tri_v3 scaffold_1774, whole genome shotgun sequence",6217,43,12,21,38,114
"NW_020168514.1 Populus trichocarpa isolate Nisqually-1 unplaced genomic scaffold, Pop_tri_v3 scaffold_1778, whole genome shotgun sequence",6777,28,11,10,25,74
"NW_020168515.1 Populus trichocarpa isolate Nisqually-1 unplaced genomic scaffold, Pop_tri_v3 scaffold_1780, whole genome shotgun sequence",6741,1,5,0,2,8
"NW_020168516.1 Populus trichocarpa isolate Nisqually-1 unplaced genomic scaffold, Pop_tri_v3 scaffold_1781, whole genome shotgun sequence",6182,29,10,12,29,80
"NW_020168517.1 Populus trichocarpa isolate Nisqually-1 unplaced genomic scaffold, Pop_tri_v3 scaffold_1782, whole genome shotgun sequence",6635,8,12,8,25,53
"NW_020168518.1 Populus trichocarpa isolate Nisqually-1 unplaced genomic scaffold, Pop_tri_v3 scaffold_1784, whole genome shotgun sequence",6305,18,5,5,10,38
"NW_020168519.1 Populus trichocarpa isolate Nisqually-1 unplaced genomic scaffold, Pop_tri_v3 scaffold_1792, whole genome shotgun sequence",6387,53,11,26,55,145
"NW_020168520.1 Populus trichocarpa isolate Nisqually-1 unplaced genomic scaffold, Pop_tri_v3 scaffold_1793, whole genome shotgun sequence",6099,39,16,21,40,116
"NW_020168521.1 Populus trichocarpa isolate Nisqually-1 unplaced genomic scaffold, Pop_tri_v3 scaffold_1797, whole genome shotgun sequence",6533,44,8,14,35,101
"NW_020168522.1 Populus trichocarpa isolate Nisqually-1 unplaced genomic scaffold, Pop_tri_v3 scaffold_1802, whole genome shotgun sequence",6229,23,12,5,25,65
"NW_020168523.1 Populus trichocarpa isolate Nisqually-1 unplaced genomic scaffold, Pop_tri_v3 scaffold_1809, whole genome shotgun sequence",6031,48,15,13,52,128
"NW_020168524.1 Populus trichocarpa isolate Nisqually-1 unplaced genomic scaffold, Pop_tri_v3 scaffold_1811, whole genome shotgun sequence",6236,22,13,13,39,87
"NW_020168525.1 Populus trichocarpa isolate Nisqually-1 unplaced genomic scaffold, Pop_tri_v3 scaffold_1812, whole genome shotgun sequence",6709,62,16,45,88,211
"NW_020168526.1 Populus trichocarpa isolate Nisqually-1 unplaced genomic scaffold, Pop_tri_v3 scaffold_1813, whole genome shotgun sequence",6256,37,10,16,43,106
"NW_020168527.1 Populus trichocarpa isolate Nisqually-1 unplaced genomic scaffold, Pop_tri_v3 scaffold_1816, whole genome shotgun sequence",5986,37,17,22,48,124
"NW_020168528.1 Populus trichocarpa isolate Nisqually-1 unplaced genomic scaffold, Pop_tri_v3 scaffold_1818, whole genome shotgun sequence",7481,9,1,6,5,21
"NW_020168529.1 Populus trichocarpa isolate Nisqually-1 unplaced genomic scaffold, Pop_tri_v3 scaffold_1820, whole genome shotgun sequence",6637,21,6,9,25,61
"NW_020168530.1 Populus trichocarpa isolate Nisqually-1 unplaced genomic scaffold, Pop_tri_v3 scaffold_1822, whole genome shotgun sequence",6698,42,12,18,60,132
"NW_020168531.1 Populus trichocarpa isolate Nisqually-1 unplaced genomic scaffold, Pop_tri_v3 scaffold_1823, whole genome shotgun sequence",7531,1,22,4,24,51
"NW_020168532.1 Populus trichocarpa isolate Nisqually-1 unplaced genomic scaffold, Pop_tri_v3 scaffold_1826, whole genome shotgun sequence",6058,38,11,28,45,122
"NW_020168533.1 Populus trichocarpa isolate Nisqually-1 unplaced genomic scaffold, Pop_tri_v3 scaffold_1827, whole genome shotgun sequence",5943,1,1,6,3,11
"NW_020168534.1 Populus trichocarpa isolate Nisqually-1 unplaced genomic scaffold, Pop_tri_v3 scaffold_1830, whole genome shotgun sequence",6138,59,6,31,53,149
"NW_020168535.1 Populus trichocarpa isolate Nisqually-1 unplaced genomic scaffold, Pop_tri_v3 scaffold_1832, whole genome shotgun sequence",10035,87,130,55,95,367
"NW_020168536.1 Populus trichocarpa isolate Nisqually-1 unplaced genomic scaffold, Pop_tri_v3 scaffold_1833, whole genome shotgun sequence",5893,46,13,25,60,144
"NW_020168537.1 Populus trichocarpa isolate Nisqually-1 unplaced genomic scaffold, Pop_tri_v3 scaffold_1834, whole genome shotgun sequence",6410,27,9,15,32,83
"NW_020168538.1 Populus trichocarpa isolate Nisqually-1 unplaced genomic scaffold, Pop_tri_v3 scaffold_1839, whole genome shotgun sequence",6196,36,10,17,44,107
"NW_020168539.1 Populus trichocarpa isolate Nisqually-1 unplaced genomic scaffold, Pop_tri_v3 scaffold_1840, whole genome shotgun sequence",5841,19,3,12,22,56
"NW_020168540.1 Populus trichocarpa isolate Nisqually-1 unplaced genomic scaffold, Pop_tri_v3 scaffold_1842, whole genome shotgun sequence",5836,63,37,34,90,224
"NW_020168541.1 Populus trichocarpa isolate Nisqually-1 unplaced genomic scaffold, Pop_tri_v3 scaffold_1843, whole genome shotgun sequence",5807,39,17,12,26,94
"NW_020168542.1 Populus trichocarpa isolate Nisqually-1 unplaced genomic scaffold, Pop_tri_v3 scaffold_1844, whole genome shotgun sequence",8178,23,11,15,20,69
"NW_020168543.1 Populus trichocarpa isolate Nisqually-1 unplaced genomic scaffold, Pop_tri_v3 scaffold_1847, whole genome shotgun sequence",9915,9,3,3,1,16
"NW_020168544.1 Populus trichocarpa isolate Nisqually-1 unplaced genomic scaffold, Pop_tri_v3 scaffold_1851, whole genome shotgun sequence",5779,19,3,5,22,49
"NW_020168545.1 Populus trichocarpa isolate Nisqually-1 unplaced genomic scaffold, Pop_tri_v3 scaffold_1855, whole genome shotgun sequence",9231,7,0,3,4,14
"NW_020168546.1 Populus trichocarpa isolate Nisqually-1 unplaced genomic scaffold, Pop_tri_v3 scaffold_1857, whole genome shotgun sequence",5748,37,19,21,44,121
"NW_020168547.1 Populus trichocarpa isolate Nisqually-1 unplaced genomic scaffold, Pop_tri_v3 scaffold_1858, whole genome shotgun sequence",6237,46,21,22,58,147
"NW_020168548.1 Populus trichocarpa isolate Nisqually-1 unplaced genomic scaffold, Pop_tri_v3 scaffold_1860, whole genome shotgun sequence",5843,24,5,13,39,81
"NW_020168549.1 Populus trichocarpa isolate Nisqually-1 unplaced genomic scaffold, Pop_tri_v3 scaffold_1861, whole genome shotgun sequence",5839,48,1,18,39,106
"NW_020168550.1 Populus trichocarpa isolate Nisqually-1 unplaced genomic scaffold, Pop_tri_v3 scaffold_1862, whole genome shotgun sequence",6422,52,10,19,67,148
"NW_020168551.1 Populus trichocarpa isolate Nisqually-1 unplaced genomic scaffold, Pop_tri_v3 scaffold_1864, whole genome shotgun sequence",6661,53,9,23,44,129
"NW_020168552.1 Populus trichocarpa isolate Nisqually-1 unplaced genomic scaffold, Pop_tri_v3 scaffold_1865, whole genome shotgun sequence",5981,42,11,20,47,120
"NW_020168553.1 Populus trichocarpa isolate Nisqually-1 unplaced genomic scaffold, Pop_tri_v3 scaffold_1866, whole genome shotgun sequence",6784,51,22,22,53,148
"NW_020168554.1 Populus trichocarpa isolate Nisqually-1 unplaced genomic scaffold, Pop_tri_v3 scaffold_1867, whole genome shotgun sequence",6654,36,13,35,60,144
"NW_020168555.1 Populus trichocarpa isolate Nisqually-1 unplaced genomic scaffold, Pop_tri_v3 scaffold_1868, whole genome shotgun sequence",5679,16,3,20,39,78
"NW_020168556.1 Populus trichocarpa isolate Nisqually-1 unplaced genomic scaffold, Pop_tri_v3 scaffold_1872, whole genome shotgun sequence",5935,22,12,17,31,82
"NW_020168557.1 Populus trichocarpa isolate Nisqually-1 unplaced genomic scaffold, Pop_tri_v3 scaffold_1879, whole genome shotgun sequence",6010,37,7,15,51,110
"NW_020168558.1 Populus trichocarpa isolate Nisqually-1 unplaced genomic scaffold, Pop_tri_v3 scaffold_1888, whole genome shotgun sequence",5666,10,8,8,7,33
"NW_020168559.1 Populus trichocarpa isolate Nisqually-1 unplaced genomic scaffold, Pop_tri_v3 scaffold_1890, whole genome shotgun sequence",5564,94,17,43,98,252
"NW_020168560.1 Populus trichocarpa isolate Nisqually-1 unplaced genomic scaffold, Pop_tri_v3 scaffold_1892, whole genome shotgun sequence",5795,49,9,22,62,142
"NW_020168561.1 Populus trichocarpa isolate Nisqually-1 unplaced genomic scaffold, Pop_tri_v3 scaffold_1893, whole genome shotgun sequence",5553,38,5,15,40,98
"NW_020168562.1 Populus trichocarpa isolate Nisqually-1 unplaced genomic scaffold, Pop_tri_v3 scaffold_1895, whole genome shotgun sequence",5651,72,6,21,80,179
"NW_020168563.1 Populus trichocarpa isolate Nisqually-1 unplaced genomic scaffold, Pop_tri_v3 scaffold_1897, whole genome shotgun sequence",5754,53,21,32,83,189
"NW_020168564.1 Populus trichocarpa isolate Nisqually-1 unplaced genomic scaffold, Pop_tri_v3 scaffold_1899, whole genome shotgun sequence",5533,26,7,11,40,84
"NW_020168565.1 Populus trichocarpa isolate Nisqually-1 unplaced genomic scaffold, Pop_tri_v3 scaffold_1901, whole genome shotgun sequence",5528,25,13,22,54,114
"NW_020168566.1 Populus trichocarpa isolate Nisqually-1 unplaced genomic scaffold, Pop_tri_v3 scaffold_1904, whole genome shotgun sequence",5619,39,17,12,40,108
"NW_020168567.1 Populus trichocarpa isolate Nisqually-1 unplaced genomic scaffold, Pop_tri_v3 scaffold_1908, whole genome shotgun sequence",5506,26,7,15,36,84
"NW_020168568.1 Populus trichocarpa isolate Nisqually-1 unplaced genomic scaffold, Pop_tri_v3 scaffold_1910, whole genome shotgun sequence",5491,110,19,54,118,301
"NW_020168569.1 Populus trichocarpa isolate Nisqually-1 unplaced genomic scaffold, Pop_tri_v3 scaffold_1911, whole genome shotgun sequence",5490,19,7,5,29,60
"NW_020168570.1 Populus trichocarpa isolate Nisqually-1 unplaced genomic scaffold, Pop_tri_v3 scaffold_1912, whole genome shotgun sequence",5481,71,9,18,59,157
"NW_020168571.1 Populus trichocarpa isolate Nisqually-1 unplaced genomic scaffold, Pop_tri_v3 scaffold_1914, whole genome shotgun sequence",6539,66,22,39,87,214
"NW_020168572.1 Populus trichocarpa isolate Nisqually-1 unplaced genomic scaffold, Pop_tri_v3 scaffold_1920, whole genome shotgun sequence",5548,42,11,29,46,128
"NW_020168573.1 Populus trichocarpa isolate Nisqually-1 unplaced genomic scaffold, Pop_tri_v3 scaffold_1921, whole genome shotgun sequence",6404,6,2,5,9,22
"NW_020168574.1 Populus trichocarpa isolate Nisqually-1 unplaced genomic scaffold, Pop_tri_v3 scaffold_1922, whole genome shotgun sequence",5543,39,18,18,21,96
"NW_020168575.1 Populus trichocarpa isolate Nisqually-1 unplaced genomic scaffold, Pop_tri_v3 scaffold_1928, whole genome shotgun sequence",5398,36,10,26,63,135
"NW_020168576.1 Populus trichocarpa isolate Nisqually-1 unplaced genomic scaffold, Pop_tri_v3 scaffold_1929, whole genome shotgun sequence",6803,23,9,18,38,88
"NW_020168577.1 Populus trichocarpa isolate Nisqually-1 unplaced genomic scaffold, Pop_tri_v3 scaffold_1930, whole genome shotgun sequence",5394,32,7,11,48,98
"NW_020168578.1 Populus trichocarpa isolate Nisqually-1 unplaced genomic scaffold, Pop_tri_v3 scaffold_1934, whole genome shotgun sequence",5794,1,12,0,13,26
"NW_020168579.1 Populus trichocarpa isolate Nisqually-1 unplaced genomic scaffold, Pop_tri_v3 scaffold_1935, whole genome shotgun sequence",5379,26,10,23,45,104
"NW_020168580.1 Populus trichocarpa isolate Nisqually-1 unplaced genomic scaffold, Pop_tri_v3 scaffold_1936, whole genome shotgun sequence",5815,35,9,13,65,122
"NW_020168581.1 Populus trichocarpa isolate Nisqually-1 unplaced genomic scaffold, Pop_tri_v3 scaffold_1937, whole genome shotgun sequence",10193,1,2,0,7,10
"NW_020168582.1 Populus trichocarpa isolate Nisqually-1 unplaced genomic scaffold, Pop_tri_v3 scaffold_1938, whole genome shotgun sequence",5687,39,20,26,54,139
"NW_020168583.1 Populus trichocarpa isolate Nisqually-1 unplaced genomic scaffold, Pop_tri_v3 scaffold_1941, whole genome shotgun sequence",5346,75,20,47,115,257
"NW_020168584.1 Populus trichocarpa isolate Nisqually-1 unplaced genomic scaffold, Pop_tri_v3 scaffold_1942, whole genome shotgun sequence",5837,12,10,5,11,38
"NW_020168585.1 Populus trichocarpa isolate Nisqually-1 unplaced genomic scaffold, Pop_tri_v3 scaffold_1943, whole genome shotgun sequence",7865,13,7,10,10,40
"NW_020168586.1 Populus trichocarpa isolate Nisqually-1 unplaced genomic scaffold, Pop_tri_v3 scaffold_1948, whole genome shotgun sequence",6468,38,8,23,38,107
"NW_020168587.1 Populus trichocarpa isolate Nisqually-1 unplaced genomic scaffold, Pop_tri_v3 scaffold_1952, whole genome shotgun sequence",5974,19,12,15,21,67
"NW_020168588.1 Populus trichocarpa isolate Nisqually-1 unplaced genomic scaffold, Pop_tri_v3 scaffold_1956, whole genome shotgun sequence",5402,32,13,21,43,109
"NW_020168589.1 Populus trichocarpa isolate Nisqually-1 unplaced genomic scaffold, Pop_tri_v3 scaffold_1957, whole genome shotgun sequence",5297,66,25,62,109,262
"NW_020168590.1 Populus trichocarpa isolate Nisqually-1 unplaced genomic scaffold, Pop_tri_v3 scaffold_1963, whole genome shotgun sequence",6337,19,3,8,14,44
"NW_020168591.1 Populus trichocarpa isolate Nisqually-1 unplaced genomic scaffold, Pop_tri_v3 scaffold_1969, whole genome shotgun sequence",5256,32,8,12,47,99
"NW_020168592.1 Populus trichocarpa isolate Nisqually-1 unplaced genomic scaffold, Pop_tri_v3 scaffold_1970, whole genome shotgun sequence",5347,39,10,19,54,122
"NW_020168593.1 Populus trichocarpa isolate Nisqually-1 unplaced genomic scaffold, Pop_tri_v3 scaffold_1975, whole genome shotgun sequence",5236,26,8,9,28,71
"NW_020168594.1 Populus trichocarpa isolate Nisqually-1 unplaced genomic scaffold, Pop_tri_v3 scaffold_1978, whole genome shotgun sequence",5221,68,25,40,135,268
"NW_020168595.1 Populus trichocarpa isolate Nisqually-1 unplaced genomic scaffold, Pop_tri_v3 scaffold_1979, whole genome shotgun sequence",5511,19,17,11,11,58
"NW_020168596.1 Populus trichocarpa isolate Nisqually-1 unplaced genomic scaffold, Pop_tri_v3 scaffold_1981, whole genome shotgun sequence",5412,6,4,1,7,18
"NW_020168597.1 Populus trichocarpa isolate Nisqually-1 unplaced genomic scaffold, Pop_tri_v3 scaffold_1982, whole genome shotgun sequence",5420,22,5,12,42,81
"NW_020168598.1 Populus trichocarpa isolate Nisqually-1 unplaced genomic scaffold, Pop_tri_v3 scaffold_1984, whole genome shotgun sequence",6675,30,7,16,34,87
"NW_020168599.1 Populus trichocarpa isolate Nisqually-1 unplaced genomic scaffold, Pop_tri_v3 scaffold_1985, whole genome shotgun sequence",5497,13,11,7,15,46
"NW_020168600.1 Populus trichocarpa isolate Nisqually-1 unplaced genomic scaffold, Pop_tri_v3 scaffold_1987, whole genome shotgun sequence",5298,24,7,13,45,89
"NW_020168601.1 Populus trichocarpa isolate Nisqually-1 unplaced genomic scaffold, Pop_tri_v3 scaffold_1991, whole genome shotgun sequence",5288,13,16,7,27,63
"NW_020168602.1 Populus trichocarpa isolate Nisqually-1 unplaced genomic scaffold, Pop_tri_v3 scaffold_1993, whole genome shotgun sequence",5512,54,11,35,79,179
"NW_020168603.1 Populus trichocarpa isolate Nisqually-1 unplaced genomic scaffold, Pop_tri_v3 scaffold_1998, whole genome shotgun sequence",6458,44,7,18,36,105
"NW_020168604.1 Populus trichocarpa isolate Nisqually-1 unplaced genomic scaffold, Pop_tri_v3 scaffold_1999, whole genome shotgun sequence",5161,26,14,14,27,81
"NW_020168605.1 Populus trichocarpa isolate Nisqually-1 unplaced genomic scaffold, Pop_tri_v3 scaffold_2000, whole genome shotgun sequence",5261,35,31,24,39,129
"NW_020168606.1 Populus trichocarpa isolate Nisqually-1 unplaced genomic scaffold, Pop_tri_v3 scaffold_2003, whole genome shotgun sequence",5752,3,2,6,4,15
"NW_020168607.1 Populus trichocarpa isolate Nisqually-1 unplaced genomic scaffold, Pop_tri_v3 scaffold_2004, whole genome shotgun sequence",5154,36,13,26,16,91
"NW_020168608.1 Populus trichocarpa isolate Nisqually-1 unplaced genomic scaffold, Pop_tri_v3 scaffold_2006, whole genome shotgun sequence",6078,26,7,13,32,78
"NW_020168609.1 Populus trichocarpa isolate Nisqually-1 unplaced genomic scaffold, Pop_tri_v3 scaffold_2009, whole genome shotgun sequence",5310,1,3,2,19,25
"NW_020168610.1 Populus trichocarpa isolate Nisqually-1 unplaced genomic scaffold, Pop_tri_v3 scaffold_2011, whole genome shotgun sequence",5134,39,4,10,38,91
"NW_020168611.1 Populus trichocarpa isolate Nisqually-1 unplaced genomic scaffold, Pop_tri_v3 scaffold_2014, whole genome shotgun sequence",5125,31,11,34,47,123
"NW_020168612.1 Populus trichocarpa isolate Nisqually-1 unplaced genomic scaffold, Pop_tri_v3 scaffold_2016, whole genome shotgun sequence",5870,16,4,5,27,52
"NW_020168613.1 Populus trichocarpa isolate Nisqually-1 unplaced genomic scaffold, Pop_tri_v3 scaffold_2020, whole genome shotgun sequence",5313,26,8,19,49,102
"NW_020168614.1 Populus trichocarpa isolate Nisqually-1 unplaced genomic scaffold, Pop_tri_v3 scaffold_2021, whole genome shotgun sequence",5106,27,8,14,38,87
"NW_020168615.1 Populus trichocarpa isolate Nisqually-1 unplaced genomic scaffold, Pop_tri_v3 scaffold_2022, whole genome shotgun sequence",5299,25,12,11,48,96
"NW_020168616.1 Populus trichocarpa isolate Nisqually-1 unplaced genomic scaffold, Pop_tri_v3 scaffold_2023, whole genome shotgun sequence",5280,28,10,11,39,88
"NW_020168617.1 Populus trichocarpa isolate Nisqually-1 unplaced genomic scaffold, Pop_tri_v3 scaffold_2024, whole genome shotgun sequence",5096,55,14,32,47,148
"NW_020168618.1 Populus trichocarpa isolate Nisqually-1 unplaced genomic scaffold, Pop_tri_v3 scaffold_2025, whole genome shotgun sequence",5095,24,12,3,14,53
"NW_020168619.1 Populus trichocarpa isolate Nisqually-1 unplaced genomic scaffold, Pop_tri_v3 scaffold_2029, whole genome shotgun sequence",5472,26,11,10,34,81
"NW_020168620.1 Populus trichocarpa isolate Nisqually-1 unplaced genomic scaffold, Pop_tri_v3 scaffold_2031, whole genome shotgun sequence",7349,16,7,6,13,42
"NW_020168621.1 Populus trichocarpa isolate Nisqually-1 unplaced genomic scaffold, Pop_tri_v3 scaffold_2035, whole genome shotgun sequence",5061,28,24,14,36,102
"NW_020168622.1 Populus trichocarpa isolate Nisqually-1 unplaced genomic scaffold, Pop_tri_v3 scaffold_2036, whole genome shotgun sequence",8462,1,2,2,5,10
"NW_020168623.1 Populus trichocarpa isolate Nisqually-1 unplaced genomic scaffold, Pop_tri_v3 scaffold_2038, whole genome shotgun sequence",5050,48,26,32,55,161
"NW_020168624.1 Populus trichocarpa isolate Nisqually-1 unplaced genomic scaffold, Pop_tri_v3 scaffold_2039, whole genome shotgun sequence",5144,5,4,3,3,15
"NW_020168625.1 Populus trichocarpa isolate Nisqually-1 unplaced genomic scaffold, Pop_tri_v3 scaffold_2041, whole genome shotgun sequence",6958,7,3,2,3,15
"NW_020168626.1 Populus trichocarpa isolate Nisqually-1 unplaced genomic scaffold, Pop_tri_v3 scaffold_2044, whole genome shotgun sequence",5021,26,14,12,49,101
"NW_020168627.1 Populus trichocarpa isolate Nisqually-1 unplaced genomic scaffold, Pop_tri_v3 scaffold_2045, whole genome shotgun sequence",5218,16,11,8,32,67
"NW_020168628.1 Populus trichocarpa isolate Nisqually-1 unplaced genomic scaffold, Pop_tri_v3 scaffold_2046, whole genome shotgun sequence",11947,3,2,3,0,8
"NW_020168629.1 Populus trichocarpa isolate Nisqually-1 unplaced genomic scaffold, Pop_tri_v3 scaffold_2048, whole genome shotgun sequence",5433,21,3,15,37,76
"NW_020168630.1 Populus trichocarpa isolate Nisqually-1 unplaced genomic scaffold, Pop_tri_v3 scaffold_2049, whole genome shotgun sequence",5150,46,20,32,66,164
"NW_020168631.1 Populus trichocarpa isolate Nisqually-1 unplaced genomic scaffold, Pop_tri_v3 scaffold_2052, whole genome shotgun sequence",5648,29,6,14,34,83
"NW_020168632.1 Populus trichocarpa isolate Nisqually-1 unplaced genomic scaffold, Pop_tri_v3 scaffold_2053, whole genome shotgun sequence",5709,30,10,21,37,98
"NW_020168633.1 Populus trichocarpa isolate Nisqually-1 unplaced genomic scaffold, Pop_tri_v3 scaffold_2055, whole genome shotgun sequence",5950,34,13,17,46,110
"NW_020168634.1 Populus trichocarpa isolate Nisqually-1 unplaced genomic scaffold, Pop_tri_v3 scaffold_2056, whole genome shotgun sequence",5945,53,15,27,62,157
"NW_020168635.1 Populus trichocarpa isolate Nisqually-1 unplaced genomic scaffold, Pop_tri_v3 scaffold_2059, whole genome shotgun sequence",4956,33,19,22,37,111
"NW_020168636.1 Populus trichocarpa isolate Nisqually-1 unplaced genomic scaffold, Pop_tri_v3 scaffold_2063, whole genome shotgun sequence",4947,27,5,8,24,64
"NW_020168637.1 Populus trichocarpa isolate Nisqually-1 unplaced genomic scaffold, Pop_tri_v3 scaffold_2064, whole genome shotgun sequence",5698,1,3,1,6,11
"NW_020168638.1 Populus trichocarpa isolate Nisqually-1 unplaced genomic scaffold, Pop_tri_v3 scaffold_2066, whole genome shotgun sequence",4944,49,28,32,45,154
"NW_020168639.1 Populus trichocarpa isolate Nisqually-1 unplaced genomic scaffold, Pop_tri_v3 scaffold_2067, whole genome shotgun sequence",5356,0,1,2,9,12
"NW_020168640.1 Populus trichocarpa isolate Nisqually-1 unplaced genomic scaffold, Pop_tri_v3 scaffold_2068, whole genome shotgun sequence",5879,66,22,26,65,179
"NW_020168641.1 Populus trichocarpa isolate Nisqually-1 unplaced genomic scaffold, Pop_tri_v3 scaffold_2070, whole genome shotgun sequence",4937,31,14,36,53,134
"NW_020168642.1 Populus trichocarpa isolate Nisqually-1 unplaced genomic scaffold, Pop_tri_v3 scaffold_2073, whole genome shotgun sequence",4915,21,4,10,24,59
"NW_020168643.1 Populus trichocarpa isolate Nisqually-1 unplaced genomic scaffold, Pop_tri_v3 scaffold_2075, whole genome shotgun sequence",5125,41,16,18,40,115
"NW_020168644.1 Populus trichocarpa isolate Nisqually-1 unplaced genomic scaffold, Pop_tri_v3 scaffold_2078, whole genome shotgun sequence",4983,22,14,25,78,139
"NW_020168645.1 Populus trichocarpa isolate Nisqually-1 unplaced genomic scaffold, Pop_tri_v3 scaffold_2079, whole genome shotgun sequence",4883,24,8,16,48,96
"NW_020168646.1 Populus trichocarpa isolate Nisqually-1 unplaced genomic scaffold, Pop_tri_v3 scaffold_2083, whole genome shotgun sequence",4878,58,8,15,56,137
"NW_020168647.1 Populus trichocarpa isolate Nisqually-1 unplaced genomic scaffold, Pop_tri_v3 scaffold_2087, whole genome shotgun sequence",5558,38,7,25,54,124
"NW_020168648.1 Populus trichocarpa isolate Nisqually-1 unplaced genomic scaffold, Pop_tri_v3 scaffold_2088, whole genome shotgun sequence",4870,40,11,10,38,99
"NW_020168649.1 Populus trichocarpa isolate Nisqually-1 unplaced genomic scaffold, Pop_tri_v3 scaffold_2089, whole genome shotgun sequence",5013,46,16,33,60,155
"NW_020168650.1 Populus trichocarpa isolate Nisqually-1 unplaced genomic scaffold, Pop_tri_v3 scaffold_2095, whole genome shotgun sequence",4856,27,5,11,23,66
"NW_020168651.1 Populus trichocarpa isolate Nisqually-1 unplaced genomic scaffold, Pop_tri_v3 scaffold_2097, whole genome shotgun sequence",6282,3,0,2,1,6
"NW_020168652.1 Populus trichocarpa isolate Nisqually-1 unplaced genomic scaffold, Pop_tri_v3 scaffold_2099, whole genome shotgun sequence",5226,19,12,10,38,79
"NW_020168653.1 Populus trichocarpa isolate Nisqually-1 unplaced genomic scaffold, Pop_tri_v3 scaffold_2100, whole genome shotgun sequence",5599,5,3,6,3,17
"NW_020168654.1 Populus trichocarpa isolate Nisqually-1 unplaced genomic scaffold, Pop_tri_v3 scaffold_2101, whole genome shotgun sequence",4844,49,21,27,88,185
"NW_020168655.1 Populus trichocarpa isolate Nisqually-1 unplaced genomic scaffold, Pop_tri_v3 scaffold_2102, whole genome shotgun sequence",4841,23,11,18,33,85
"NW_020168656.1 Populus trichocarpa isolate Nisqually-1 unplaced genomic scaffold, Pop_tri_v3 scaffold_2109, whole genome shotgun sequence",5801,2,0,1,1,4
"NW_020168657.1 Populus trichocarpa isolate Nisqually-1 unplaced genomic scaffold, Pop_tri_v3 scaffold_2110, whole genome shotgun sequence",5345,5,6,6,13,30
"NW_020168658.1 Populus trichocarpa isolate Nisqually-1 unplaced genomic scaffold, Pop_tri_v3 scaffold_2112, whole genome shotgun sequence",4804,16,2,5,34,57
"NW_020168659.1 Populus trichocarpa isolate Nisqually-1 unplaced genomic scaffold, Pop_tri_v3 scaffold_2116, whole genome shotgun sequence",5062,43,24,23,67,157
"NW_020168660.1 Populus trichocarpa isolate Nisqually-1 unplaced genomic scaffold, Pop_tri_v3 scaffold_2118, whole genome shotgun sequence",4888,38,8,16,34,96
"NW_020168661.1 Populus trichocarpa isolate Nisqually-1 unplaced genomic scaffold, Pop_tri_v3 scaffold_2130, whole genome shotgun sequence",4747,15,12,11,37,75
"NW_020168662.1 Populus trichocarpa isolate Nisqually-1 unplaced genomic scaffold, Pop_tri_v3 scaffold_2133, whole genome shotgun sequence",5003,44,10,22,50,126
"NW_020168663.1 Populus trichocarpa isolate Nisqually-1 unplaced genomic scaffold, Pop_tri_v3 scaffold_2134, whole genome shotgun sequence",4885,19,3,12,39,73
"NW_020168664.1 Populus trichocarpa isolate Nisqually-1 unplaced genomic scaffold, Pop_tri_v3 scaffold_2135, whole genome shotgun sequence",4729,60,25,31,108,224
"NW_020168665.1 Populus trichocarpa isolate Nisqually-1 unplaced genomic scaffold, Pop_tri_v3 scaffold_2139, whole genome shotgun sequence",6028,30,9,15,47,101
"NW_020168666.1 Populus trichocarpa isolate Nisqually-1 unplaced genomic scaffold, Pop_tri_v3 scaffold_2141, whole genome shotgun sequence",5224,42,0,15,28,85
"NW_020168667.1 Populus trichocarpa isolate Nisqually-1 unplaced genomic scaffold, Pop_tri_v3 scaffold_2146, whole genome shotgun sequence",4703,4,0,4,6,14
"NW_020168668.1 Populus trichocarpa isolate Nisqually-1 unplaced genomic scaffold, Pop_tri_v3 scaffold_2147, whole genome shotgun sequence",5579,46,15,26,69,156
"NW_020168669.1 Populus trichocarpa isolate Nisqually-1 unplaced genomic scaffold, Pop_tri_v3 scaffold_2149, whole genome shotgun sequence",6708,2,10,2,4,18
"NW_020168670.1 Populus trichocarpa isolate Nisqually-1 unplaced genomic scaffold, Pop_tri_v3 scaffold_2151, whole genome shotgun sequence",4795,33,2,18,23,76
"NW_020168671.1 Populus trichocarpa isolate Nisqually-1 unplaced genomic scaffold, Pop_tri_v3 scaffold_2153, whole genome shotgun sequence",4693,44,13,24,60,141
"NW_020168672.1 Populus trichocarpa isolate Nisqually-1 unplaced genomic scaffold, Pop_tri_v3 scaffold_2159, whole genome shotgun sequence",4680,23,5,16,43,87
"NW_020168673.1 Populus trichocarpa isolate Nisqually-1 unplaced genomic scaffold, Pop_tri_v3 scaffold_2160, whole genome shotgun sequence",4676,19,7,18,25,69
"NW_020168674.1 Populus trichocarpa isolate Nisqually-1 unplaced genomic scaffold, Pop_tri_v3 scaffold_2161, whole genome shotgun sequence",6035,8,5,5,4,22
"NW_020168675.1 Populus trichocarpa isolate Nisqually-1 unplaced genomic scaffold, Pop_tri_v3 scaffold_2162, whole genome shotgun sequence",4671,28,15,15,34,92
"NW_020168676.1 Populus trichocarpa isolate Nisqually-1 unplaced genomic scaffold, Pop_tri_v3 scaffold_2166, whole genome shotgun sequence",11631,5,8,7,4,24
"NW_020168677.1 Populus trichocarpa isolate Nisqually-1 unplaced genomic scaffold, Pop_tri_v3 scaffold_2169, whole genome shotgun sequence",5858,25,9,16,34,84
"NW_020168678.1 Populus trichocarpa isolate Nisqually-1 unplaced genomic scaffold, Pop_tri_v3 scaffold_2171, whole genome shotgun sequence",4649,20,8,10,23,61
"NW_020168679.1 Populus trichocarpa isolate Nisqually-1 unplaced genomic scaffold, Pop_tri_v3 scaffold_2173, whole genome shotgun sequence",4740,80,4,31,47,162
"NW_020168680.1 Populus trichocarpa isolate Nisqually-1 unplaced genomic scaffold, Pop_tri_v3 scaffold_2174, whole genome shotgun sequence",4638,68,164,73,123,428
"NW_020168681.1 Populus trichocarpa isolate Nisqually-1 unplaced genomic scaffold, Pop_tri_v3 scaffold_2175, whole genome shotgun sequence",4836,40,11,25,51,127
"NW_020168682.1 Populus trichocarpa isolate Nisqually-1 unplaced genomic scaffold, Pop_tri_v3 scaffold_2178, whole genome shotgun sequence",4632,37,13,18,58,126
"NW_020168683.1 Populus trichocarpa isolate Nisqually-1 unplaced genomic scaffold, Pop_tri_v3 scaffold_2183, whole genome shotgun sequence",4712,29,14,27,57,127
"NW_020168684.1 Populus trichocarpa isolate Nisqually-1 unplaced genomic scaffold, Pop_tri_v3 scaffold_2185, whole genome shotgun sequence",4801,34,14,14,36,98
"NW_020168685.1 Populus trichocarpa isolate Nisqually-1 unplaced genomic scaffold, Pop_tri_v3 scaffold_2186, whole genome shotgun sequence",4705,45,4,22,30,101
"NW_020168686.1 Populus trichocarpa isolate Nisqually-1 unplaced genomic scaffold, Pop_tri_v3 scaffold_2189, whole genome shotgun sequence",4595,73,8,26,86,193
"NW_020168687.1 Populus trichocarpa isolate Nisqually-1 unplaced genomic scaffold, Pop_tri_v3 scaffold_2190, whole genome shotgun sequence",5123,15,31,9,30,85
"NW_020168688.1 Populus trichocarpa isolate Nisqually-1 unplaced genomic scaffold, Pop_tri_v3 scaffold_2191, whole genome shotgun sequence",4591,4,4,3,14,25
"NW_020168689.1 Populus trichocarpa isolate Nisqually-1 unplaced genomic scaffold, Pop_tri_v3 scaffold_2193, whole genome shotgun sequence",4588,14,19,20,37,90
"NW_020168690.1 Populus trichocarpa isolate Nisqually-1 unplaced genomic scaffold, Pop_tri_v3 scaffold_2194, whole genome shotgun sequence",4584,21,12,12,31,76
"NW_020168691.1 Populus trichocarpa isolate Nisqually-1 unplaced genomic scaffold, Pop_tri_v3 scaffold_2197, whole genome shotgun sequence",4569,35,13,19,37,104
"NW_020168692.1 Populus trichocarpa isolate Nisqually-1 unplaced genomic scaffold, Pop_tri_v3 scaffold_2202, whole genome shotgun sequence",4559,45,7,23,62,137
"NW_020168693.1 Populus trichocarpa isolate Nisqually-1 unplaced genomic scaffold, Pop_tri_v3 scaffold_2204, whole genome shotgun sequence",4552,32,3,8,36,79
"NW_020168694.1 Populus trichocarpa isolate Nisqually-1 unplaced genomic scaffold, Pop_tri_v3 scaffold_2206, whole genome shotgun sequence",4547,4,0,3,6,13
"NW_020168695.1 Populus trichocarpa isolate Nisqually-1 unplaced genomic scaffold, Pop_tri_v3 scaffold_2207, whole genome shotgun sequence",4540,37,9,16,33,95
"NW_020168696.1 Populus trichocarpa isolate Nisqually-1 unplaced genomic scaffold, Pop_tri_v3 scaffold_2208, whole genome shotgun sequence",8629,32,14,30,26,102
"NW_020168697.1 Populus trichocarpa isolate Nisqually-1 unplaced genomic scaffold, Pop_tri_v3 scaffold_2209, whole genome shotgun sequence",5677,36,11,21,47,115
"NW_020168698.1 Populus trichocarpa isolate Nisqually-1 unplaced genomic scaffold, Pop_tri_v3 scaffold_2210, whole genome shotgun sequence",4528,29,4,10,21,64
"NW_020168699.1 Populus trichocarpa isolate Nisqually-1 unplaced genomic scaffold, Pop_tri_v3 scaffold_2212, whole genome shotgun sequence",4872,11,5,5,19,40
"NW_020168700.1 Populus trichocarpa isolate Nisqually-1 unplaced genomic scaffold, Pop_tri_v3 scaffold_2213, whole genome shotgun sequence",4645,7,2,1,15,25
"NW_020168701.1 Populus trichocarpa isolate Nisqually-1 unplaced genomic scaffold, Pop_tri_v3 scaffold_2215, whole genome shotgun sequence",4522,23,15,14,28,80
"NW_020168702.1 Populus trichocarpa isolate Nisqually-1 unplaced genomic scaffold, Pop_tri_v3 scaffold_2220, whole genome shotgun sequence",4514,23,5,8,17,53
"NW_020168703.1 Populus trichocarpa isolate Nisqually-1 unplaced genomic scaffold, Pop_tri_v3 scaffold_2221, whole genome shotgun sequence",5275,21,7,12,25,65
"NW_020168704.1 Populus trichocarpa isolate Nisqually-1 unplaced genomic scaffold, Pop_tri_v3 scaffold_2222, whole genome shotgun sequence",38600,3,3,2,5,13
"NW_020168705.1 Populus trichocarpa isolate Nisqually-1 unplaced genomic scaffold, Pop_tri_v3 scaffold_2223, whole genome shotgun sequence",4609,25,5,14,40,84
"NW_020168706.1 Populus trichocarpa isolate Nisqually-1 unplaced genomic scaffold, Pop_tri_v3 scaffold_2229, whole genome shotgun sequence",4496,36,6,13,39,94
"NW_020168707.1 Populus trichocarpa isolate Nisqually-1 unplaced genomic scaffold, Pop_tri_v3 scaffold_2232, whole genome shotgun sequence",4662,35,6,18,42,101
"NW_020168708.1 Populus trichocarpa isolate Nisqually-1 unplaced genomic scaffold, Pop_tri_v3 scaffold_2233, whole genome shotgun sequence",5138,35,10,19,46,110
"NW_020168709.1 Populus trichocarpa isolate Nisqually-1 unplaced genomic scaffold, Pop_tri_v3 scaffold_2234, whole genome shotgun sequence",5000,41,9,13,38,101
"NW_020168710.1 Populus trichocarpa isolate Nisqually-1 unplaced genomic scaffold, Pop_tri_v3 scaffold_2235, whole genome shotgun sequence",4582,7,3,2,4,16
"NW_020168711.1 Populus trichocarpa isolate Nisqually-1 unplaced genomic scaffold, Pop_tri_v3 scaffold_2236, whole genome shotgun sequence",4478,29,9,17,20,75
"NW_020168712.1 Populus trichocarpa isolate Nisqually-1 unplaced genomic scaffold, Pop_tri_v3 scaffold_2237, whole genome shotgun sequence",4745,22,16,16,27,81
"NW_020168713.1 Populus trichocarpa isolate Nisqually-1 unplaced genomic scaffold, Pop_tri_v3 scaffold_2239, whole genome shotgun sequence",5012,36,15,30,35,116
"NW_020168714.1 Populus trichocarpa isolate Nisqually-1 unplaced genomic scaffold, Pop_tri_v3 scaffold_2240, whole genome shotgun sequence",4860,22,10,14,22,68
"NW_020168715.1 Populus trichocarpa isolate Nisqually-1 unplaced genomic scaffold, Pop_tri_v3 scaffold_2243, whole genome shotgun sequence",4567,8,2,14,9,33
"NW_020168716.1 Populus trichocarpa isolate Nisqually-1 unplaced genomic scaffold, Pop_tri_v3 scaffold_2244, whole genome shotgun sequence",4927,21,5,14,21,61
"NW_020168717.1 Populus trichocarpa isolate Nisqually-1 unplaced genomic scaffold, Pop_tri_v3 scaffold_2246, whole genome shotgun sequence",4460,9,6,9,25,49
"NW_020168718.1 Populus trichocarpa isolate Nisqually-1 unplaced genomic scaffold, Pop_tri_v3 scaffold_2247, whole genome shotgun sequence",7084,16,3,3,11,33
"NW_020168719.1 Populus trichocarpa isolate Nisqually-1 unplaced genomic scaffold, Pop_tri_v3 scaffold_2248, whole genome shotgun sequence",4546,1,2,0,11,14
"NW_020168720.1 Populus trichocarpa isolate Nisqually-1 unplaced genomic scaffold, Pop_tri_v3 scaffold_2249, whole genome shotgun sequence",4544,48,17,37,112,214
"NW_020168721.1 Populus trichocarpa isolate Nisqually-1 unplaced genomic scaffold, Pop_tri_v3 scaffold_2250, whole genome shotgun sequence",4441,44,7,22,69,142
"NW_020168722.1 Populus trichocarpa isolate Nisqually-1 unplaced genomic scaffold, Pop_tri_v3 scaffold_2253, whole genome shotgun sequence",4439,33,6,9,38,86
"NW_020168723.1 Populus trichocarpa isolate Nisqually-1 unplaced genomic scaffold, Pop_tri_v3 scaffold_2258, whole genome shotgun sequence",5697,3,5,2,2,12
"NW_020168724.1 Populus trichocarpa isolate Nisqually-1 unplaced genomic scaffold, Pop_tri_v3 scaffold_2259, whole genome shotgun sequence",5487,28,8,11,26,73
"NW_020168725.1 Populus trichocarpa isolate Nisqually-1 unplaced genomic scaffold, Pop_tri_v3 scaffold_2261, whole genome shotgun sequence",4425,10,8,3,8,29
"NW_020168726.1 Populus trichocarpa isolate Nisqually-1 unplaced genomic scaffold, Pop_tri_v3 scaffold_2262, whole genome shotgun sequence",4424,37,15,21,30,103
"NW_020168727.1 Populus trichocarpa isolate Nisqually-1 unplaced genomic scaffold, Pop_tri_v3 scaffold_2264, whole genome shotgun sequence",4420,28,10,6,30,74
"NW_020168728.1 Populus trichocarpa isolate Nisqually-1 unplaced genomic scaffold, Pop_tri_v3 scaffold_2266, whole genome shotgun sequence",4415,22,8,13,31,74
"NW_020168729.1 Populus trichocarpa isolate Nisqually-1 unplaced genomic scaffold, Pop_tri_v3 scaffold_2268, whole genome shotgun sequence",4409,20,7,16,31,74
"NW_020168730.1 Populus trichocarpa isolate Nisqually-1 unplaced genomic scaffold, Pop_tri_v3 scaffold_2269, whole genome shotgun sequence",4677,15,10,5,11,41
"NW_020168731.1 Populus trichocarpa isolate Nisqually-1 unplaced genomic scaffold, Pop_tri_v3 scaffold_2273, whole genome shotgun sequence",5099,37,7,21,24,89
"NW_020168732.1 Populus trichocarpa isolate Nisqually-1 unplaced genomic scaffold, Pop_tri_v3 scaffold_2279, whole genome shotgun sequence",4851,41,7,21,31,100
"NW_020168733.1 Populus trichocarpa isolate Nisqually-1 unplaced genomic scaffold, Pop_tri_v3 scaffold_2280, whole genome shotgun sequence",4392,12,12,4,18,46
"NW_020168734.1 Populus trichocarpa isolate Nisqually-1 unplaced genomic scaffold, Pop_tri_v3 scaffold_2285, whole genome shotgun sequence",5912,19,9,5,16,49
"NW_020168735.1 Populus trichocarpa isolate Nisqually-1 unplaced genomic scaffold, Pop_tri_v3 scaffold_2289, whole genome shotgun sequence",4374,62,19,33,88,202
"NW_020168736.1 Populus trichocarpa isolate Nisqually-1 unplaced genomic scaffold, Pop_tri_v3 scaffold_2291, whole genome shotgun sequence",5482,48,7,26,76,157
"NW_020168737.1 Populus trichocarpa isolate Nisqually-1 unplaced genomic scaffold, Pop_tri_v3 scaffold_2295, whole genome shotgun sequence",5397,9,4,3,10,26
"NW_020168738.1 Populus trichocarpa isolate Nisqually-1 unplaced genomic scaffold, Pop_tri_v3 scaffold_2298, whole genome shotgun sequence",4360,17,10,21,36,84
"NW_020168739.1 Populus trichocarpa isolate Nisqually-1 unplaced genomic scaffold, Pop_tri_v3 scaffold_2300, whole genome shotgun sequence",4742,5,2,1,4,12
"NW_020168740.1 Populus trichocarpa isolate Nisqually-1 unplaced genomic scaffold, Pop_tri_v3 scaffold_2303, whole genome shotgun sequence",4350,21,1,6,20,48
"NW_020168741.1 Populus trichocarpa isolate Nisqually-1 unplaced genomic scaffold, Pop_tri_v3 scaffold_2306, whole genome shotgun sequence",4436,5,1,1,2,9
"NW_020168742.1 Populus trichocarpa isolate Nisqually-1 unplaced genomic scaffold, Pop_tri_v3 scaffold_2309, whole genome shotgun sequence",4325,19,8,18,39,84
"NW_020168743.1 Populus trichocarpa isolate Nisqually-1 unplaced genomic scaffold, Pop_tri_v3 scaffold_2310, whole genome shotgun sequence",4812,1,10,1,0,12
"NW_020168744.1 Populus trichocarpa isolate Nisqually-1 unplaced genomic scaffold, Pop_tri_v3 scaffold_2311, whole genome shotgun sequence",4907,27,12,24,32,95
"NW_020168745.1 Populus trichocarpa isolate Nisqually-1 unplaced genomic scaffold, Pop_tri_v3 scaffold_2312, whole genome shotgun sequence",4625,38,19,16,51,124
"NW_020168746.1 Populus trichocarpa isolate Nisqually-1 unplaced genomic scaffold, Pop_tri_v3 scaffold_2313, whole genome shotgun sequence",4559,38,11,20,44,113
"NW_020168747.1 Populus trichocarpa isolate Nisqually-1 unplaced genomic scaffold, Pop_tri_v3 scaffold_2314, whole genome shotgun sequence",5104,40,12,17,32,101
"NW_020168748.1 Populus trichocarpa isolate Nisqually-1 unplaced genomic scaffold, Pop_tri_v3 scaffold_2315, whole genome shotgun sequence",4317,19,8,10,30,67
"NW_020168749.1 Populus trichocarpa isolate Nisqually-1 unplaced genomic scaffold, Pop_tri_v3 scaffold_2316, whole genome shotgun sequence",4535,28,20,17,25,90
"NW_020168750.1 Populus trichocarpa isolate Nisqually-1 unplaced genomic scaffold, Pop_tri_v3 scaffold_2317, whole genome shotgun sequence",5885,46,25,21,78,170
"NW_020168751.1 Populus trichocarpa isolate Nisqually-1 unplaced genomic scaffold, Pop_tri_v3 scaffold_2320, whole genome shotgun sequence",4299,22,6,16,34,78
"NW_020168752.1 Populus trichocarpa isolate Nisqually-1 unplaced genomic scaffold, Pop_tri_v3 scaffold_2322, whole genome shotgun sequence",5902,12,7,10,8,37
"NW_020168753.1 Populus trichocarpa isolate Nisqually-1 unplaced genomic scaffold, Pop_tri_v3 scaffold_2323, whole genome shotgun sequence",4294,29,8,15,31,83
"NW_020168754.1 Populus trichocarpa isolate Nisqually-1 unplaced genomic scaffold, Pop_tri_v3 scaffold_2324, whole genome shotgun sequence",4293,19,7,11,21,58
"NW_020168755.1 Populus trichocarpa isolate Nisqually-1 unplaced genomic scaffold, Pop_tri_v3 scaffold_2325, whole genome shotgun sequence",4544,19,5,6,18,48
"NW_020168756.1 Populus trichocarpa isolate Nisqually-1 unplaced genomic scaffold, Pop_tri_v3 scaffold_2327, whole genome shotgun sequence",4286,24,4,15,34,77
"NW_020168757.1 Populus trichocarpa isolate Nisqually-1 unplaced genomic scaffold, Pop_tri_v3 scaffold_2328, whole genome shotgun sequence",4284,24,10,9,22,65
"NW_020168758.1 Populus trichocarpa isolate Nisqually-1 unplaced genomic scaffold, Pop_tri_v3 scaffold_2329, whole genome shotgun sequence",4501,28,16,20,38,102
"NW_020168759.1 Populus trichocarpa isolate Nisqually-1 unplaced genomic scaffold, Pop_tri_v3 scaffold_2330, whole genome shotgun sequence",4703,15,3,1,9,28
"NW_020168760.1 Populus trichocarpa isolate Nisqually-1 unplaced genomic scaffold, Pop_tri_v3 scaffold_2331, whole genome shotgun sequence",4277,24,4,10,21,59
"NW_020168761.1 Populus trichocarpa isolate Nisqually-1 unplaced genomic scaffold, Pop_tri_v3 scaffold_2332, whole genome shotgun sequence",4276,25,15,9,27,76
"NW_020168762.1 Populus trichocarpa isolate Nisqually-1 unplaced genomic scaffold, Pop_tri_v3 scaffold_2335, whole genome shotgun sequence",4447,17,6,5,14,42
"NW_020168763.1 Populus trichocarpa isolate Nisqually-1 unplaced genomic scaffold, Pop_tri_v3 scaffold_2336, whole genome shotgun sequence",8023,2,8,5,3,18
"NW_020168764.1 Populus trichocarpa isolate Nisqually-1 unplaced genomic scaffold, Pop_tri_v3 scaffold_2337, whole genome shotgun sequence",4476,11,8,2,4,25
"NW_020168765.1 Populus trichocarpa isolate Nisqually-1 unplaced genomic scaffold, Pop_tri_v3 scaffold_2338, whole genome shotgun sequence",4442,26,5,12,46,89
"NW_020168766.1 Populus trichocarpa isolate Nisqually-1 unplaced genomic scaffold, Pop_tri_v3 scaffold_2339, whole genome shotgun sequence",5224,20,18,18,48,104
"NW_020168767.1 Populus trichocarpa isolate Nisqually-1 unplaced genomic scaffold, Pop_tri_v3 scaffold_2340, whole genome shotgun sequence",4356,29,13,13,34,89
"NW_020168768.1 Populus trichocarpa isolate Nisqually-1 unplaced genomic scaffold, Pop_tri_v3 scaffold_2342, whole genome shotgun sequence",4248,22,8,13,27,70
"NW_020168769.1 Populus trichocarpa isolate Nisqually-1 unplaced genomic scaffold, Pop_tri_v3 scaffold_2344, whole genome shotgun sequence",4633,17,4,12,25,58
"NW_020168770.1 Populus trichocarpa isolate Nisqually-1 unplaced genomic scaffold, Pop_tri_v3 scaffold_2345, whole genome shotgun sequence",4447,20,14,7,29,70
"NW_020168771.1 Populus trichocarpa isolate Nisqually-1 unplaced genomic scaffold, Pop_tri_v3 scaffold_2348, whole genome shotgun sequence",4230,29,13,21,39,102
"NW_020168772.1 Populus trichocarpa isolate Nisqually-1 unplaced genomic scaffold, Pop_tri_v3 scaffold_2349, whole genome shotgun sequence",5037,1,0,1,2,4
"NW_020168773.1 Populus trichocarpa isolate Nisqually-1 unplaced genomic scaffold, Pop_tri_v3 scaffold_2357, whole genome shotgun sequence",4198,23,13,14,45,95
"NW_020168774.1 Populus trichocarpa isolate Nisqually-1 unplaced genomic scaffold, Pop_tri_v3 scaffold_2360, whole genome shotgun sequence",4828,22,8,12,44,86
"NW_020168775.1 Populus trichocarpa isolate Nisqually-1 unplaced genomic scaffold, Pop_tri_v3 scaffold_2362, whole genome shotgun sequence",4181,24,13,10,22,69
"NW_020168776.1 Populus trichocarpa isolate Nisqually-1 unplaced genomic scaffold, Pop_tri_v3 scaffold_2364, whole genome shotgun sequence",4648,52,11,26,56,145
"NW_020168777.1 Populus trichocarpa isolate Nisqually-1 unplaced genomic scaffold, Pop_tri_v3 scaffold_2367, whole genome shotgun sequence",4523,6,3,4,1,14
"NW_020168778.1 Populus trichocarpa isolate Nisqually-1 unplaced genomic scaffold, Pop_tri_v3 scaffold_2368, whole genome shotgun sequence",4165,27,8,18,37,90
"NW_020168779.1 Populus trichocarpa isolate Nisqually-1 unplaced genomic scaffold, Pop_tri_v3 scaffold_2370, whole genome shotgun sequence",4504,34,13,15,52,114
"NW_020168780.1 Populus trichocarpa isolate Nisqually-1 unplaced genomic scaffold, Pop_tri_v3 scaffold_2372, whole genome shotgun sequence",4155,43,9,6,30,88
"NW_020168781.1 Populus trichocarpa isolate Nisqually-1 unplaced genomic scaffold, Pop_tri_v3 scaffold_2374, whole genome shotgun sequence",5111,32,13,12,44,101
"NW_020168782.1 Populus trichocarpa isolate Nisqually-1 unplaced genomic scaffold, Pop_tri_v3 scaffold_2376, whole genome shotgun sequence",5519,2,5,1,2,10
"NW_020168783.1 Populus trichocarpa isolate Nisqually-1 unplaced genomic scaffold, Pop_tri_v3 scaffold_2377, whole genome shotgun sequence",4603,4,0,4,5,13
"NW_020168784.1 Populus trichocarpa isolate Nisqually-1 unplaced genomic scaffold, Pop_tri_v3 scaffold_2378, whole genome shotgun sequence",4725,36,9,20,16,81
"NW_020168785.1 Populus trichocarpa isolate Nisqually-1 unplaced genomic scaffold, Pop_tri_v3 scaffold_2379, whole genome shotgun sequence",6297,8,5,0,19,32
"NW_020168786.1 Populus trichocarpa isolate Nisqually-1 unplaced genomic scaffold, Pop_tri_v3 scaffold_2381, whole genome shotgun sequence",4117,25,20,18,25,88
"NW_020168787.1 Populus trichocarpa isolate Nisqually-1 unplaced genomic scaffold, Pop_tri_v3 scaffold_2383, whole genome shotgun sequence",4115,24,10,6,19,59
"NW_020168788.1 Populus trichocarpa isolate Nisqually-1 unplaced genomic scaffold, Pop_tri_v3 scaffold_2384, whole genome shotgun sequence",4115,18,2,10,35,65
"NW_020168789.1 Populus trichocarpa isolate Nisqually-1 unplaced genomic scaffold, Pop_tri_v3 scaffold_2385, whole genome shotgun sequence",5005,19,10,16,47,92
"NW_020168790.1 Populus trichocarpa isolate Nisqually-1 unplaced genomic scaffold, Pop_tri_v3 scaffold_2387, whole genome shotgun sequence",4383,5,5,6,2,18
"NW_020168791.1 Populus trichocarpa isolate Nisqually-1 unplaced genomic scaffold, Pop_tri_v3 scaffold_2390, whole genome shotgun sequence",4094,39,4,11,33,87
"NW_020168792.1 Populus trichocarpa isolate Nisqually-1 unplaced genomic scaffold, Pop_tri_v3 scaffold_2394, whole genome shotgun sequence",4829,36,2,9,38,85
"NW_020168793.1 Populus trichocarpa isolate Nisqually-1 unplaced genomic scaffold, Pop_tri_v3 scaffold_2396, whole genome shotgun sequence",4317,28,11,15,36,90
"NW_020168794.1 Populus trichocarpa isolate Nisqually-1 unplaced genomic scaffold, Pop_tri_v3 scaffold_2397, whole genome shotgun sequence",4408,17,9,8,13,47
"NW_020168795.1 Populus trichocarpa isolate Nisqually-1 unplaced genomic scaffold, Pop_tri_v3 scaffold_2410, whole genome shotgun sequence",4051,20,14,9,41,84
"NW_020168796.1 Populus trichocarpa isolate Nisqually-1 unplaced genomic scaffold, Pop_tri_v3 scaffold_2412, whole genome shotgun sequence",5024,33,5,19,34,91
"NW_020168797.1 Populus trichocarpa isolate Nisqually-1 unplaced genomic scaffold, Pop_tri_v3 scaffold_2413, whole genome shotgun sequence",4040,39,10,14,52,115
"NW_020168798.1 Populus trichocarpa isolate Nisqually-1 unplaced genomic scaffold, Pop_tri_v3 scaffold_2414, whole genome shotgun sequence",4034,25,8,16,11,60
"NW_020168799.1 Populus trichocarpa isolate Nisqually-1 unplaced genomic scaffold, Pop_tri_v3 scaffold_2418, whole genome shotgun sequence",4563,26,12,10,18,66
"NW_020168800.1 Populus trichocarpa isolate Nisqually-1 unplaced genomic scaffold, Pop_tri_v3 scaffold_2422, whole genome shotgun sequence",4008,29,5,8,30,72
"NW_020168801.1 Populus trichocarpa isolate Nisqually-1 unplaced genomic scaffold, Pop_tri_v3 scaffold_2424, whole genome shotgun sequence",4099,9,18,12,24,63
"NW_020168802.1 Populus trichocarpa isolate Nisqually-1 unplaced genomic scaffold, Pop_tri_v3 scaffold_2428, whole genome shotgun sequence",4402,24,13,10,16,63
"NW_020168803.1 Populus trichocarpa isolate Nisqually-1 unplaced genomic scaffold, Pop_tri_v3 scaffold_2431, whole genome shotgun sequence",3982,19,2,10,37,68
"NW_020168804.1 Populus trichocarpa isolate Nisqually-1 unplaced genomic scaffold, Pop_tri_v3 scaffold_2432, whole genome shotgun sequence",3981,78,10,41,54,183
"NW_020168805.1 Populus trichocarpa isolate Nisqually-1 unplaced genomic scaffold, Pop_tri_v3 scaffold_2434, whole genome shotgun sequence",3979,20,10,6,13,49
"NW_020168806.1 Populus trichocarpa isolate Nisqually-1 unplaced genomic scaffold, Pop_tri_v3 scaffold_2439, whole genome shotgun sequence",4603,5,9,1,6,21
"NW_020168807.1 Populus trichocarpa isolate Nisqually-1 unplaced genomic scaffold, Pop_tri_v3 scaffold_2444, whole genome shotgun sequence",4435,32,11,26,49,118
"NW_020168808.1 Populus trichocarpa isolate Nisqually-1 unplaced genomic scaffold, Pop_tri_v3 scaffold_2446, whole genome shotgun sequence",3945,30,5,20,37,92
"NW_020168809.1 Populus trichocarpa isolate Nisqually-1 unplaced genomic scaffold, Pop_tri_v3 scaffold_2447, whole genome shotgun sequence",3942,4,1,0,0,5
"NW_020168810.1 Populus trichocarpa isolate Nisqually-1 unplaced genomic scaffold, Pop_tri_v3 scaffold_2449, whole genome shotgun sequence",3940,12,4,5,13,34
"NW_020168811.1 Populus trichocarpa isolate Nisqually-1 unplaced genomic scaffold, Pop_tri_v3 scaffold_2453, whole genome shotgun sequence",4227,23,6,10,26,65
"NW_020168812.1 Populus trichocarpa isolate Nisqually-1 unplaced genomic scaffold, Pop_tri_v3 scaffold_2454, whole genome shotgun sequence",3927,16,9,14,36,75
"NW_020168813.1 Populus trichocarpa isolate Nisqually-1 unplaced genomic scaffold, Pop_tri_v3 scaffold_2458, whole genome shotgun sequence",3915,12,4,11,38,65
"NW_020168814.1 Populus trichocarpa isolate Nisqually-1 unplaced genomic scaffold, Pop_tri_v3 scaffold_2459, whole genome shotgun sequence",3910,60,39,50,98,247
"NW_020168815.1 Populus trichocarpa isolate Nisqually-1 unplaced genomic scaffold, Pop_tri_v3 scaffold_2460, whole genome shotgun sequence",4157,6,7,5,5,23
"NW_020168816.1 Populus trichocarpa isolate Nisqually-1 unplaced genomic scaffold, Pop_tri_v3 scaffold_2462, whole genome shotgun sequence",3907,49,22,31,22,124
"NW_020168817.1 Populus trichocarpa isolate Nisqually-1 unplaced genomic scaffold, Pop_tri_v3 scaffold_2463, whole genome shotgun sequence",4005,6,1,1,10,18
"NW_020168818.1 Populus trichocarpa isolate Nisqually-1 unplaced genomic scaffold, Pop_tri_v3 scaffold_2465, whole genome shotgun sequence",3900,17,7,7,17,48
"NW_020168819.1 Populus trichocarpa isolate Nisqually-1 unplaced genomic scaffold, Pop_tri_v3 scaffold_2468, whole genome shotgun sequence",4415,32,8,16,50,106
"NW_020168820.1 Populus trichocarpa isolate Nisqually-1 unplaced genomic scaffold, Pop_tri_v3 scaffold_2469, whole genome shotgun sequence",4383,14,10,3,15,42
"NW_020168821.1 Populus trichocarpa isolate Nisqually-1 unplaced genomic scaffold, Pop_tri_v3 scaffold_2471, whole genome shotgun sequence",25283,11,18,11,10,50
"NW_020168822.1 Populus trichocarpa isolate Nisqually-1 unplaced genomic scaffold, Pop_tri_v3 scaffold_2474, whole genome shotgun sequence",4171,33,7,11,33,84
"NW_020168823.1 Populus trichocarpa isolate Nisqually-1 unplaced genomic scaffold, Pop_tri_v3 scaffold_2475, whole genome shotgun sequence",4383,34,17,22,48,121
"NW_020168824.1 Populus trichocarpa isolate Nisqually-1 unplaced genomic scaffold, Pop_tri_v3 scaffold_2476, whole genome shotgun sequence",3879,23,6,16,33,78
"NW_020168825.1 Populus trichocarpa isolate Nisqually-1 unplaced genomic scaffold, Pop_tri_v3 scaffold_2478, whole genome shotgun sequence",3876,32,4,8,36,80
"NW_020168826.1 Populus trichocarpa isolate Nisqually-1 unplaced genomic scaffold, Pop_tri_v3 scaffold_2479, whole genome shotgun sequence",5622,11,2,4,11,28
"NW_020168827.1 Populus trichocarpa isolate Nisqually-1 unplaced genomic scaffold, Pop_tri_v3 scaffold_2481, whole genome shotgun sequence",3867,25,6,10,15,56
"NW_020168828.1 Populus trichocarpa isolate Nisqually-1 unplaced genomic scaffold, Pop_tri_v3 scaffold_2483, whole genome shotgun sequence",4520,18,9,6,15,48
"NW_020168829.1 Populus trichocarpa isolate Nisqually-1 unplaced genomic scaffold, Pop_tri_v3 scaffold_2486, whole genome shotgun sequence",3852,2,0,4,8,14
"NW_020168830.1 Populus trichocarpa isolate Nisqually-1 unplaced genomic scaffold, Pop_tri_v3 scaffold_2487, whole genome shotgun sequence",3851,36,3,13,38,90
"NW_020168831.1 Populus trichocarpa isolate Nisqually-1 unplaced genomic scaffold, Pop_tri_v3 scaffold_2489, whole genome shotgun sequence",4754,4,0,3,1,8
"NW_020168832.1 Populus trichocarpa isolate Nisqually-1 unplaced genomic scaffold, Pop_tri_v3 scaffold_2491, whole genome shotgun sequence",5921,3,2,3,0,8
"NW_020168833.1 Populus trichocarpa isolate Nisqually-1 unplaced genomic scaffold, Pop_tri_v3 scaffold_2493, whole genome shotgun sequence",4954,0,1,4,4,9
"NW_020168834.1 Populus trichocarpa isolate Nisqually-1 unplaced genomic scaffold, Pop_tri_v3 scaffold_2495, whole genome shotgun sequence",3830,13,21,14,39,87
"NW_020168835.1 Populus trichocarpa isolate Nisqually-1 unplaced genomic scaffold, Pop_tri_v3 scaffold_2498, whole genome shotgun sequence",5711,5,3,0,8,16
"NW_020168836.1 Populus trichocarpa isolate Nisqually-1 unplaced genomic scaffold, Pop_tri_v3 scaffold_2499, whole genome shotgun sequence",3827,17,8,11,39,75
"NW_020168837.1 Populus trichocarpa isolate Nisqually-1 unplaced genomic scaffold, Pop_tri_v3 scaffold_2500, whole genome shotgun sequence",3926,27,1,9,20,57
"NW_020168838.1 Populus trichocarpa isolate Nisqually-1 unplaced genomic scaffold, Pop_tri_v3 scaffold_2502, whole genome shotgun sequence",9499,1,4,1,1,7
"NW_020168839.1 Populus trichocarpa isolate Nisqually-1 unplaced genomic scaffold, Pop_tri_v3 scaffold_2503, whole genome shotgun sequence",3819,33,8,10,19,70
"NW_020168840.1 Populus trichocarpa isolate Nisqually-1 unplaced genomic scaffold, Pop_tri_v3 scaffold_2504, whole genome shotgun sequence",4486,17,0,5,13,35
"NW_020168841.1 Populus trichocarpa isolate Nisqually-1 unplaced genomic scaffold, Pop_tri_v3 scaffold_2508, whole genome shotgun sequence",3929,24,6,7,25,62
"NW_020168842.1 Populus trichocarpa isolate Nisqually-1 unplaced genomic scaffold, Pop_tri_v3 scaffold_2510, whole genome shotgun sequence",3923,18,9,7,25,59
"NW_020168843.1 Populus trichocarpa isolate Nisqually-1 unplaced genomic scaffold, Pop_tri_v3 scaffold_2511, whole genome shotgun sequence",3801,19,6,14,28,67
"NW_020168844.1 Populus trichocarpa isolate Nisqually-1 unplaced genomic scaffold, Pop_tri_v3 scaffold_2512, whole genome shotgun sequence",4133,27,9,12,29,77
"NW_020168845.1 Populus trichocarpa isolate Nisqually-1 unplaced genomic scaffold, Pop_tri_v3 scaffold_2517, whole genome shotgun sequence",3784,40,12,17,42,111
"NW_020168846.1 Populus trichocarpa isolate Nisqually-1 unplaced genomic scaffold, Pop_tri_v3 scaffold_2522, whole genome shotgun sequence",3775,34,7,25,49,115
"NW_020168847.1 Populus trichocarpa isolate Nisqually-1 unplaced genomic scaffold, Pop_tri_v3 scaffold_2523, whole genome shotgun sequence",7089,1,2,3,3,9
"NW_020168848.1 Populus trichocarpa isolate Nisqually-1 unplaced genomic scaffold, Pop_tri_v3 scaffold_2525, whole genome shotgun sequence",4192,25,5,13,19,62
"NW_020168849.1 Populus trichocarpa isolate Nisqually-1 unplaced genomic scaffold, Pop_tri_v3 scaffold_2527, whole genome shotgun sequence",3763,22,4,10,19,55
"NW_020168850.1 Populus trichocarpa isolate Nisqually-1 unplaced genomic scaffold, Pop_tri_v3 scaffold_2528, whole genome shotgun sequence",3759,13,4,4,23,44
"NW_020168851.1 Populus trichocarpa isolate Nisqually-1 unplaced genomic scaffold, Pop_tri_v3 scaffold_2530, whole genome shotgun sequence",3756,14,4,12,11,41
"NW_020168852.1 Populus trichocarpa isolate Nisqually-1 unplaced genomic scaffold, Pop_tri_v3 scaffold_2531, whole genome shotgun sequence",4027,25,5,11,22,63
"NW_020168853.1 Populus trichocarpa isolate Nisqually-1 unplaced genomic scaffold, Pop_tri_v3 scaffold_2532, whole genome shotgun sequence",4126,10,4,13,5,32
"NW_020168854.1 Populus trichocarpa isolate Nisqually-1 unplaced genomic scaffold, Pop_tri_v3 scaffold_2533, whole genome shotgun sequence",4101,25,6,20,38,89
"NW_020168855.1 Populus trichocarpa isolate Nisqually-1 unplaced genomic scaffold, Pop_tri_v3 scaffold_2535, whole genome shotgun sequence",3744,20,9,18,40,87
"NW_020168856.1 Populus trichocarpa isolate Nisqually-1 unplaced genomic scaffold, Pop_tri_v3 scaffold_2536, whole genome shotgun sequence",4451,19,3,4,22,48
"NW_020168857.1 Populus trichocarpa isolate Nisqually-1 unplaced genomic scaffold, Pop_tri_v3 scaffold_2538, whole genome shotgun sequence",4328,1,7,0,2,10
"NW_020168858.1 Populus trichocarpa isolate Nisqually-1 unplaced genomic scaffold, Pop_tri_v3 scaffold_2540, whole genome shotgun sequence",3737,23,2,8,23,56
"NW_020168859.1 Populus trichocarpa isolate Nisqually-1 unplaced genomic scaffold, Pop_tri_v3 scaffold_2543, whole genome shotgun sequence",4078,6,1,2,2,11
"NW_020168860.1 Populus trichocarpa isolate Nisqually-1 unplaced genomic scaffold, Pop_tri_v3 scaffold_2548, whole genome shotgun sequence",3725,34,9,27,38,108
"NW_020168861.1 Populus trichocarpa isolate Nisqually-1 unplaced genomic scaffold, Pop_tri_v3 scaffold_2549, whole genome shotgun sequence",4024,27,19,22,47,115
"NW_020168862.1 Populus trichocarpa isolate Nisqually-1 unplaced genomic scaffold, Pop_tri_v3 scaffold_2551, whole genome shotgun sequence",3718,59,27,46,61,193
"NW_020168863.1 Populus trichocarpa isolate Nisqually-1 unplaced genomic scaffold, Pop_tri_v3 scaffold_2552, whole genome shotgun sequence",3717,34,14,24,55,127
"NW_020168864.1 Populus trichocarpa isolate Nisqually-1 unplaced genomic scaffold, Pop_tri_v3 scaffold_2553, whole genome shotgun sequence",4015,28,3,23,36,90
"NW_020168865.1 Populus trichocarpa isolate Nisqually-1 unplaced genomic scaffold, Pop_tri_v3 scaffold_2554, whole genome shotgun sequence",3712,10,3,1,10,24
"NW_020168866.1 Populus trichocarpa isolate Nisqually-1 unplaced genomic scaffold, Pop_tri_v3 scaffold_2557, whole genome shotgun sequence",3704,23,7,9,14,53
"NW_020168867.1 Populus trichocarpa isolate Nisqually-1 unplaced genomic scaffold, Pop_tri_v3 scaffold_2560, whole genome shotgun sequence",6310,36,6,15,32,89
"NW_020168868.1 Populus trichocarpa isolate Nisqually-1 unplaced genomic scaffold, Pop_tri_v3 scaffold_2561, whole genome shotgun sequence",4047,8,2,3,1,14
"NW_020168869.1 Populus trichocarpa isolate Nisqually-1 unplaced genomic scaffold, Pop_tri_v3 scaffold_2562, whole genome shotgun sequence",4074,13,8,10,36,67
"NW_020168870.1 Populus trichocarpa isolate Nisqually-1 unplaced genomic scaffold, Pop_tri_v3 scaffold_2564, whole genome shotgun sequence",4009,6,6,9,5,26
"NW_020168871.1 Populus trichocarpa isolate Nisqually-1 unplaced genomic scaffold, Pop_tri_v3 scaffold_2565, whole genome shotgun sequence",4337,1,0,0,2,3
"NW_020168872.1 Populus trichocarpa isolate Nisqually-1 unplaced genomic scaffold, Pop_tri_v3 scaffold_2566, whole genome shotgun sequence",14238,1,0,2,1,4
"NW_020168873.1 Populus trichocarpa isolate Nisqually-1 unplaced genomic scaffold, Pop_tri_v3 scaffold_2568, whole genome shotgun sequence",4216,10,7,6,19,42
"NW_020168874.1 Populus trichocarpa isolate Nisqually-1 unplaced genomic scaffold, Pop_tri_v3 scaffold_2570, whole genome shotgun sequence",4403,28,16,21,34,99
"NW_020168875.1 Populus trichocarpa isolate Nisqually-1 unplaced genomic scaffold, Pop_tri_v3 scaffold_2571, whole genome shotgun sequence",3681,16,10,14,33,73
"NW_020168876.1 Populus trichocarpa isolate Nisqually-1 unplaced genomic scaffold, Pop_tri_v3 scaffold_2574, whole genome shotgun sequence",4273,6,2,2,7,17
"NW_020168877.1 Populus trichocarpa isolate Nisqually-1 unplaced genomic scaffold, Pop_tri_v3 scaffold_2575, whole genome shotgun sequence",5124,3,13,4,16,36
"NW_020168878.1 Populus trichocarpa isolate Nisqually-1 unplaced genomic scaffold, Pop_tri_v3 scaffold_2576, whole genome shotgun sequence",4153,20,6,11,18,55
"NW_020168879.1 Populus trichocarpa isolate Nisqually-1 unplaced genomic scaffold, Pop_tri_v3 scaffold_2578, whole genome shotgun sequence",3672,12,6,2,8,28
"NW_020168880.1 Populus trichocarpa isolate Nisqually-1 unplaced genomic scaffold, Pop_tri_v3 scaffold_2581, whole genome shotgun sequence",3662,30,10,10,37,87
"NW_020168881.1 Populus trichocarpa isolate Nisqually-1 unplaced genomic scaffold, Pop_tri_v3 scaffold_2584, whole genome shotgun sequence",6843,34,4,9,31,78
"NW_020168882.1 Populus trichocarpa isolate Nisqually-1 unplaced genomic scaffold, Pop_tri_v3 scaffold_2586, whole genome shotgun sequence",6360,24,5,21,30,80
"NW_020168883.1 Populus trichocarpa isolate Nisqually-1 unplaced genomic scaffold, Pop_tri_v3 scaffold_2590, whole genome shotgun sequence",3629,25,9,18,30,82
"NW_020168884.1 Populus trichocarpa isolate Nisqually-1 unplaced genomic scaffold, Pop_tri_v3 scaffold_2595, whole genome shotgun sequence",3717,19,16,12,20,67
"NW_020168885.1 Populus trichocarpa isolate Nisqually-1 unplaced genomic scaffold, Pop_tri_v3 scaffold_2596, whole genome shotgun sequence",4009,0,2,0,2,4
"NW_020168886.1 Populus trichocarpa isolate Nisqually-1 unplaced genomic scaffold, Pop_tri_v3 scaffold_2600, whole genome shotgun sequence",4219,15,7,14,31,67
"NW_020168887.1 Populus trichocarpa isolate Nisqually-1 unplaced genomic scaffold, Pop_tri_v3 scaffold_2601, whole genome shotgun sequence",3597,21,14,19,23,77
"NW_020168888.1 Populus trichocarpa isolate Nisqually-1 unplaced genomic scaffold, Pop_tri_v3 scaffold_2603, whole genome shotgun sequence",3590,45,11,24,62,142
"NW_020168889.1 Populus trichocarpa isolate Nisqually-1 unplaced genomic scaffold, Pop_tri_v3 scaffold_2606, whole genome shotgun sequence",3578,14,19,11,22,66
"NW_020168890.1 Populus trichocarpa isolate Nisqually-1 unplaced genomic scaffold, Pop_tri_v3 scaffold_2609, whole genome shotgun sequence",4160,8,4,1,4,17
"NW_020168891.1 Populus trichocarpa isolate Nisqually-1 unplaced genomic scaffold, Pop_tri_v3 scaffold_2610, whole genome shotgun sequence",3747,0,2,1,1,4
"NW_020168892.1 Populus trichocarpa isolate Nisqually-1 unplaced genomic scaffold, Pop_tri_v3 scaffold_2615, whole genome shotgun sequence",3658,20,8,16,19,63
"NW_020168893.1 Populus trichocarpa isolate Nisqually-1 unplaced genomic scaffold, Pop_tri_v3 scaffold_2616, whole genome shotgun sequence",4275,13,9,11,20,53
"NW_020168894.1 Populus trichocarpa isolate Nisqually-1 unplaced genomic scaffold, Pop_tri_v3 scaffold_2617, whole genome shotgun sequence",3553,65,27,65,81,238
"NW_020168895.1 Populus trichocarpa isolate Nisqually-1 unplaced genomic scaffold, Pop_tri_v3 scaffold_2618, whole genome shotgun sequence",3553,30,8,15,37,90
"NW_020168896.1 Populus trichocarpa isolate Nisqually-1 unplaced genomic scaffold, Pop_tri_v3 scaffold_2619, whole genome shotgun sequence",4779,27,11,14,25,77
"NW_020168897.1 Populus trichocarpa isolate Nisqually-1 unplaced genomic scaffold, Pop_tri_v3 scaffold_2620, whole genome shotgun sequence",3640,8,4,4,17,33
"NW_020168898.1 Populus trichocarpa isolate Nisqually-1 unplaced genomic scaffold, Pop_tri_v3 scaffold_2621, whole genome shotgun sequence",4175,25,8,11,44,88
"NW_020168899.1 Populus trichocarpa isolate Nisqually-1 unplaced genomic scaffold, Pop_tri_v3 scaffold_2623, whole genome shotgun sequence",4044,30,8,12,47,97
"NW_020168900.1 Populus trichocarpa isolate Nisqually-1 unplaced genomic scaffold, Pop_tri_v3 scaffold_2624, whole genome shotgun sequence",4074,39,10,24,38,111
"NW_020168901.1 Populus trichocarpa isolate Nisqually-1 unplaced genomic scaffold, Pop_tri_v3 scaffold_2627, whole genome shotgun sequence",3528,16,8,8,30,62
"NW_020168902.1 Populus trichocarpa isolate Nisqually-1 unplaced genomic scaffold, Pop_tri_v3 scaffold_2630, whole genome shotgun sequence",3526,34,8,12,38,92
"NW_020168903.1 Populus trichocarpa isolate Nisqually-1 unplaced genomic scaffold, Pop_tri_v3 scaffold_2632, whole genome shotgun sequence",3625,19,8,9,24,60
"NW_020168904.1 Populus trichocarpa isolate Nisqually-1 unplaced genomic scaffold, Pop_tri_v3 scaffold_2637, whole genome shotgun sequence",4014,36,13,23,28,100
"NW_020168905.1 Populus trichocarpa isolate Nisqually-1 unplaced genomic scaffold, Pop_tri_v3 scaffold_2638, whole genome shotgun sequence",3934,18,7,12,21,58
"NW_020168906.1 Populus trichocarpa isolate Nisqually-1 unplaced genomic scaffold, Pop_tri_v3 scaffold_2640, whole genome shotgun sequence",3633,25,4,16,25,70
"NW_020168907.1 Populus trichocarpa isolate Nisqually-1 unplaced genomic scaffold, Pop_tri_v3 scaffold_2642, whole genome shotgun sequence",4333,6,1,7,13,27
"NW_020168908.1 Populus trichocarpa isolate Nisqually-1 unplaced genomic scaffold, Pop_tri_v3 scaffold_2645, whole genome shotgun sequence",3491,8,3,1,3,15
"NW_020168909.1 Populus trichocarpa isolate Nisqually-1 unplaced genomic scaffold, Pop_tri_v3 scaffold_2646, whole genome shotgun sequence",4649,20,16,14,35,85
"NW_020168910.1 Populus trichocarpa isolate Nisqually-1 unplaced genomic scaffold, Pop_tri_v3 scaffold_2653, whole genome shotgun sequence",5812,3,1,2,1,7
"NW_020168911.1 Populus trichocarpa isolate Nisqually-1 unplaced genomic scaffold, Pop_tri_v3 scaffold_2654, whole genome shotgun sequence",3589,30,9,12,27,78
"NW_020168912.1 Populus trichocarpa isolate Nisqually-1 unplaced genomic scaffold, Pop_tri_v3 scaffold_2658, whole genome shotgun sequence",3470,29,7,13,17,66
"NW_020168913.1 Populus trichocarpa isolate Nisqually-1 unplaced genomic scaffold, Pop_tri_v3 scaffold_2660, whole genome shotgun sequence",4130,14,8,8,16,46
"NW_020168914.1 Populus trichocarpa isolate Nisqually-1 unplaced genomic scaffold, Pop_tri_v3 scaffold_2662, whole genome shotgun sequence",4130,6,0,4,3,13
"NW_020168915.1 Populus trichocarpa isolate Nisqually-1 unplaced genomic scaffold, Pop_tri_v3 scaffold_2664, whole genome shotgun sequence",3593,1,0,0,1,2
"NW_020168916.1 Populus trichocarpa isolate Nisqually-1 unplaced genomic scaffold, Pop_tri_v3 scaffold_2667, whole genome shotgun sequence",3900,15,3,5,20,43
"NW_020168917.1 Populus trichocarpa isolate Nisqually-1 unplaced genomic scaffold, Pop_tri_v3 scaffold_2670, whole genome shotgun sequence",5203,46,12,22,39,119
"NW_020168918.1 Populus trichocarpa isolate Nisqually-1 unplaced genomic scaffold, Pop_tri_v3 scaffold_2671, whole genome shotgun sequence",3426,19,6,12,24,61
"NW_020168919.1 Populus trichocarpa isolate Nisqually-1 unplaced genomic scaffold, Pop_tri_v3 scaffold_2674, whole genome shotgun sequence",3644,4,1,1,1,7
"NW_020168920.1 Populus trichocarpa isolate Nisqually-1 unplaced genomic scaffold, Pop_tri_v3 scaffold_2676, whole genome shotgun sequence",3417,35,11,14,30,90
"NW_020168921.1 Populus trichocarpa isolate Nisqually-1 unplaced genomic scaffold, Pop_tri_v3 scaffold_2677, whole genome shotgun sequence",3825,14,7,8,18,47
"NW_020168922.1 Populus trichocarpa isolate Nisqually-1 unplaced genomic scaffold, Pop_tri_v3 scaffold_2678, whole genome shotgun sequence",3514,1,6,1,5,13
"NW_020168923.1 Populus trichocarpa isolate Nisqually-1 unplaced genomic scaffold, Pop_tri_v3 scaffold_2682, whole genome shotgun sequence",4973,1,18,5,14,38
"NW_020168924.1 Populus trichocarpa isolate Nisqually-1 unplaced genomic scaffold, Pop_tri_v3 scaffold_2685, whole genome shotgun sequence",3596,2,1,2,2,7
"NW_020168925.1 Populus trichocarpa isolate Nisqually-1 unplaced genomic scaffold, Pop_tri_v3 scaffold_2688, whole genome shotgun sequence",3492,9,2,2,2,15
"NW_020168926.1 Populus trichocarpa isolate Nisqually-1 unplaced genomic scaffold, Pop_tri_v3 scaffold_2689, whole genome shotgun sequence",3390,41,14,22,41,118
"NW_020168927.1 Populus trichocarpa isolate Nisqually-1 unplaced genomic scaffold, Pop_tri_v3 scaffold_2690, whole genome shotgun sequence",3389,25,4,6,24,59
"NW_020168928.1 Populus trichocarpa isolate Nisqually-1 unplaced genomic scaffold, Pop_tri_v3 scaffold_2695, whole genome shotgun sequence",4063,24,7,17,27,75
"NW_020168929.1 Populus trichocarpa isolate Nisqually-1 unplaced genomic scaffold, Pop_tri_v3 scaffold_2698, whole genome shotgun sequence",3361,5,1,0,10,16
"NW_020168930.1 Populus trichocarpa isolate Nisqually-1 unplaced genomic scaffold, Pop_tri_v3 scaffold_2700, whole genome shotgun sequence",3357,4,0,2,3,9
"NW_020168931.1 Populus trichocarpa isolate Nisqually-1 unplaced genomic scaffold, Pop_tri_v3 scaffold_2703, whole genome shotgun sequence",3470,25,10,24,47,106
"NW_020168932.1 Populus trichocarpa isolate Nisqually-1 unplaced genomic scaffold, Pop_tri_v3 scaffold_2705, whole genome shotgun sequence",4430,20,3,6,28,57
"NW_020168933.1 Populus trichocarpa isolate Nisqually-1 unplaced genomic scaffold, Pop_tri_v3 scaffold_2706, whole genome shotgun sequence",3345,3,6,14,12,35
"NW_020168934.1 Populus trichocarpa isolate Nisqually-1 unplaced genomic scaffold, Pop_tri_v3 scaffold_2709, whole genome shotgun sequence",4729,0,12,1,8,21
"NW_020168935.1 Populus trichocarpa isolate Nisqually-1 unplaced genomic scaffold, Pop_tri_v3 scaffold_2711, whole genome shotgun sequence",3331,18,5,6,11,40
"NW_020168936.1 Populus trichocarpa isolate Nisqually-1 unplaced genomic scaffold, Pop_tri_v3 scaffold_2714, whole genome shotgun sequence",3323,71,17,36,70,194
"NW_020168937.1 Populus trichocarpa isolate Nisqually-1 unplaced genomic scaffold, Pop_tri_v3 scaffold_2716, whole genome shotgun sequence",3602,9,3,11,9,32
"NW_020168938.1 Populus trichocarpa isolate Nisqually-1 unplaced genomic scaffold, Pop_tri_v3 scaffold_2719, whole genome shotgun sequence",3961,21,7,9,21,58
"NW_020168939.1 Populus trichocarpa isolate Nisqually-1 unplaced genomic scaffold, Pop_tri_v3 scaffold_2721, whole genome shotgun sequence",3872,1,5,3,4,13
"NW_020168940.1 Populus trichocarpa isolate Nisqually-1 unplaced genomic scaffold, Pop_tri_v3 scaffold_2723, whole genome shotgun sequence",3889,16,6,14,32,68
"NW_020168941.1 Populus trichocarpa isolate Nisqually-1 unplaced genomic scaffold, Pop_tri_v3 scaffold_2724, whole genome shotgun sequence",6029,38,11,12,51,112
"NW_020168942.1 Populus trichocarpa isolate Nisqually-1 unplaced genomic scaffold, Pop_tri_v3 scaffold_2726, whole genome shotgun sequence",3293,6,4,4,6,20
"NW_020168943.1 Populus trichocarpa isolate Nisqually-1 unplaced genomic scaffold, Pop_tri_v3 scaffold_2728, whole genome shotgun sequence",3916,4,0,0,4,8
"NW_020168944.1 Populus trichocarpa isolate Nisqually-1 unplaced genomic scaffold, Pop_tri_v3 scaffold_2733, whole genome shotgun sequence",3468,12,4,3,16,35
"NW_020168945.1 Populus trichocarpa isolate Nisqually-1 unplaced genomic scaffold, Pop_tri_v3 scaffold_2735, whole genome shotgun sequence",5633,1,5,2,5,13
"NW_020168946.1 Populus trichocarpa isolate Nisqually-1 unplaced genomic scaffold, Pop_tri_v3 scaffold_2736, whole genome shotgun sequence",3259,30,7,13,39,89
"NW_020168947.1 Populus trichocarpa isolate Nisqually-1 unplaced genomic scaffold, Pop_tri_v3 scaffold_2741, whole genome shotgun sequence",3255,14,6,9,12,41
"NW_020168948.1 Populus trichocarpa isolate Nisqually-1 unplaced genomic scaffold, Pop_tri_v3 scaffold_2742, whole genome shotgun sequence",3351,18,3,14,35,70
"NW_020168949.1 Populus trichocarpa isolate Nisqually-1 unplaced genomic scaffold, Pop_tri_v3 scaffold_2744, whole genome shotgun sequence",3247,1,0,0,1,2
"NW_020168950.1 Populus trichocarpa isolate Nisqually-1 unplaced genomic scaffold, Pop_tri_v3 scaffold_2747, whole genome shotgun sequence",4870,4,1,5,7,17
"NW_020168951.1 Populus trichocarpa isolate Nisqually-1 unplaced genomic scaffold, Pop_tri_v3 scaffold_2748, whole genome shotgun sequence",3780,10,2,6,11,29
"NW_020168952.1 Populus trichocarpa isolate Nisqually-1 unplaced genomic scaffold, Pop_tri_v3 scaffold_2750, whole genome shotgun sequence",5442,0,1,1,4,6
"NW_020168953.1 Populus trichocarpa isolate Nisqually-1 unplaced genomic scaffold, Pop_tri_v3 scaffold_2751, whole genome shotgun sequence",4372,6,3,1,6,16
"NW_020168954.1 Populus trichocarpa isolate Nisqually-1 unplaced genomic scaffold, Pop_tri_v3 scaffold_2752, whole genome shotgun sequence",3320,18,9,11,26,64
"NW_020168955.1 Populus trichocarpa isolate Nisqually-1 unplaced genomic scaffold, Pop_tri_v3 scaffold_2754, whole genome shotgun sequence",4122,2,3,2,9,16
"NW_020168956.1 Populus trichocarpa isolate Nisqually-1 unplaced genomic scaffold, Pop_tri_v3 scaffold_2755, whole genome shotgun sequence",3453,3,4,2,0,9
"NW_020168957.1 Populus trichocarpa isolate Nisqually-1 unplaced genomic scaffold, Pop_tri_v3 scaffold_2756, whole genome shotgun sequence",3211,12,6,5,6,29
"NW_020168958.1 Populus trichocarpa isolate Nisqually-1 unplaced genomic scaffold, Pop_tri_v3 scaffold_2758, whole genome shotgun sequence",3914,4,5,4,20,33
"NW_020168959.1 Populus trichocarpa isolate Nisqually-1 unplaced genomic scaffold, Pop_tri_v3 scaffold_2760, whole genome shotgun sequence",6366,11,2,6,9,28
"NW_020168960.1 Populus trichocarpa isolate Nisqually-1 unplaced genomic scaffold, Pop_tri_v3 scaffold_2762, whole genome shotgun sequence",3202,38,6,17,19,80
"NW_020168961.1 Populus trichocarpa isolate Nisqually-1 unplaced genomic scaffold, Pop_tri_v3 scaffold_2764, whole genome shotgun sequence",3869,27,15,17,23,82
"NW_020168962.1 Populus trichocarpa isolate Nisqually-1 unplaced genomic scaffold, Pop_tri_v3 scaffold_2765, whole genome shotgun sequence",3473,4,8,3,8,23
"NW_020168963.1 Populus trichocarpa isolate Nisqually-1 unplaced genomic scaffold, Pop_tri_v3 scaffold_2767, whole genome shotgun sequence",3823,14,3,6,16,39
"NW_020168964.1 Populus trichocarpa isolate Nisqually-1 unplaced genomic scaffold, Pop_tri_v3 scaffold_2770, whole genome shotgun sequence",3173,15,10,4,20,49
"NW_020168965.1 Populus trichocarpa isolate Nisqually-1 unplaced genomic scaffold, Pop_tri_v3 scaffold_2772, whole genome shotgun sequence",4445,30,0,12,21,63
"NW_020168966.1 Populus trichocarpa isolate Nisqually-1 unplaced genomic scaffold, Pop_tri_v3 scaffold_2773, whole genome shotgun sequence",3389,3,3,3,5,14
"NW_020168967.1 Populus trichocarpa isolate Nisqually-1 unplaced genomic scaffold, Pop_tri_v3 scaffold_2774, whole genome shotgun sequence",3149,0,0,0,1,1
"NW_020168968.1 Populus trichocarpa isolate Nisqually-1 unplaced genomic scaffold, Pop_tri_v3 scaffold_2775, whole genome shotgun sequence",3144,60,89,43,66,258
"NW_020168969.1 Populus trichocarpa isolate Nisqually-1 unplaced genomic scaffold, Pop_tri_v3 scaffold_2776, whole genome shotgun sequence",3144,5,6,6,13,30
"NW_020168970.1 Populus trichocarpa isolate Nisqually-1 unplaced genomic scaffold, Pop_tri_v3 scaffold_2777, whole genome shotgun sequence",3143,15,4,0,11,30
"NW_020168971.1 Populus trichocarpa isolate Nisqually-1 unplaced genomic scaffold, Pop_tri_v3 scaffold_2779, whole genome shotgun sequence",3551,12,1,5,22,40
"NW_020168972.1 Populus trichocarpa isolate Nisqually-1 unplaced genomic scaffold, Pop_tri_v3 scaffold_2781, whole genome shotgun sequence",3347,19,9,13,11,52
"NW_020168973.1 Populus trichocarpa isolate Nisqually-1 unplaced genomic scaffold, Pop_tri_v3 scaffold_2782, whole genome shotgun sequence",3232,31,4,18,44,97
"NW_020168974.1 Populus trichocarpa isolate Nisqually-1 unplaced genomic scaffold, Pop_tri_v3 scaffold_2785, whole genome shotgun sequence",3280,11,3,5,20,39
"NW_020168975.1 Populus trichocarpa isolate Nisqually-1 unplaced genomic scaffold, Pop_tri_v3 scaffold_2786, whole genome shotgun sequence",3128,19,17,11,33,80
"NW_020168976.1 Populus trichocarpa isolate Nisqually-1 unplaced genomic scaffold, Pop_tri_v3 scaffold_2788, whole genome shotgun sequence",3122,16,2,8,17,43
"NW_020168977.1 Populus trichocarpa isolate Nisqually-1 unplaced genomic scaffold, Pop_tri_v3 scaffold_2789, whole genome shotgun sequence",3687,4,4,4,4,16
"NW_020168978.1 Populus trichocarpa isolate Nisqually-1 unplaced genomic scaffold, Pop_tri_v3 scaffold_2800, whole genome shotgun sequence",3852,5,4,4,2,15
"NW_020168979.1 Populus trichocarpa isolate Nisqually-1 unplaced genomic scaffold, Pop_tri_v3 scaffold_2804, whole genome shotgun sequence",4005,0,0,0,0,0
"NW_020168980.1 Populus trichocarpa isolate Nisqually-1 unplaced genomic scaffold, Pop_tri_v3 scaffold_2806, whole genome shotgun sequence",4778,1,5,0,0,6
"NW_020168981.1 Populus trichocarpa isolate Nisqually-1 unplaced genomic scaffold, Pop_tri_v3 scaffold_2807, whole genome shotgun sequence",4462,7,8,10,10,35
"NW_020168982.1 Populus trichocarpa isolate Nisqually-1 unplaced genomic scaffold, Pop_tri_v3 scaffold_2809, whole genome shotgun sequence",4390,5,8,5,4,22
"NW_020168983.1 Populus trichocarpa isolate Nisqually-1 unplaced genomic scaffold, Pop_tri_v3 scaffold_2812, whole genome shotgun sequence",3718,1,2,1,7,11
"NW_020168984.1 Populus trichocarpa isolate Nisqually-1 unplaced genomic scaffold, Pop_tri_v3 scaffold_2813, whole genome shotgun sequence",3049,29,22,26,34,111
"NW_020168985.1 Populus trichocarpa isolate Nisqually-1 unplaced genomic scaffold, Pop_tri_v3 scaffold_2814, whole genome shotgun sequence",3048,1,0,0,1,2
"NW_020168986.1 Populus trichocarpa isolate Nisqually-1 unplaced genomic scaffold, Pop_tri_v3 scaffold_2816, whole genome shotgun sequence",4027,13,5,6,21,45
"NW_020168987.1 Populus trichocarpa isolate Nisqually-1 unplaced genomic scaffold, Pop_tri_v3 scaffold_2820, whole genome shotgun sequence",3742,13,4,8,14,39
"NW_020168988.1 Populus trichocarpa isolate Nisqually-1 unplaced genomic scaffold, Pop_tri_v3 scaffold_2821, whole genome shotgun sequence",3407,2,0,0,0,2
"NW_020168989.1 Populus trichocarpa isolate Nisqually-1 unplaced genomic scaffold, Pop_tri_v3 scaffold_2824, whole genome shotgun sequence",6033,2,0,4,4,10
"NW_020168990.1 Populus trichocarpa isolate Nisqually-1 unplaced genomic scaffold, Pop_tri_v3 scaffold_2825, whole genome shotgun sequence",3575,11,2,3,6,22
"NW_020168991.1 Populus trichocarpa isolate Nisqually-1 unplaced genomic scaffold, Pop_tri_v3 scaffold_2826, whole genome shotgun sequence",3032,3,1,1,3,8
"NW_020168992.1 Populus trichocarpa isolate Nisqually-1 unplaced genomic scaffold, Pop_tri_v3 scaffold_2828, whole genome shotgun sequence",3026,72,14,25,46,157
"NW_020168993.1 Populus trichocarpa isolate Nisqually-1 unplaced genomic scaffold, Pop_tri_v3 scaffold_2829, whole genome shotgun sequence",7021,5,5,0,6,16
"NW_020168994.1 Populus trichocarpa isolate Nisqually-1 unplaced genomic scaffold, Pop_tri_v3 scaffold_2832, whole genome shotgun sequence",3532,15,10,4,16,45
"NW_020168995.1 Populus trichocarpa isolate Nisqually-1 unplaced genomic scaffold, Pop_tri_v3 scaffold_2835, whole genome shotgun sequence",3187,7,3,8,13,31
"NW_020168996.1 Populus trichocarpa isolate Nisqually-1 unplaced genomic scaffold, Pop_tri_v3 scaffold_2837, whole genome shotgun sequence",3758,15,3,9,19,46
"NW_020168997.1 Populus trichocarpa isolate Nisqually-1 unplaced genomic scaffold, Pop_tri_v3 scaffold_2838, whole genome shotgun sequence",2988,3,0,1,2,6
"NW_020168998.1 Populus trichocarpa isolate Nisqually-1 unplaced genomic scaffold, Pop_tri_v3 scaffold_2841, whole genome shotgun sequence",4422,0,3,0,0,3
"NW_020168999.1 Populus trichocarpa isolate Nisqually-1 unplaced genomic scaffold, Pop_tri_v3 scaffold_2842, whole genome shotgun sequence",3249,3,2,2,3,10
"NW_020169000.1 Populus trichocarpa isolate Nisqually-1 unplaced genomic scaffold, Pop_tri_v3 scaffold_2844, whole genome shotgun sequence",2966,8,8,4,8,28
"NW_020169001.1 Populus trichocarpa isolate Nisqually-1 unplaced genomic scaffold, Pop_tri_v3 scaffold_2851, whole genome shotgun sequence",2950,4,3,2,3,12
"NW_020169002.1 Populus trichocarpa isolate Nisqually-1 unplaced genomic scaffold, Pop_tri_v3 scaffold_2853, whole genome shotgun sequence",2935,10,6,9,19,44
"NW_020169003.1 Populus trichocarpa isolate Nisqually-1 unplaced genomic scaffold, Pop_tri_v3 scaffold_2855, whole genome shotgun sequence",2931,6,3,7,2,18
"NW_020169004.1 Populus trichocarpa isolate Nisqually-1 unplaced genomic scaffold, Pop_tri_v3 scaffold_2857, whole genome shotgun sequence",2929,20,15,15,52,102
"NW_020169005.1 Populus trichocarpa isolate Nisqually-1 unplaced genomic scaffold, Pop_tri_v3 scaffold_2859, whole genome shotgun sequence",3755,2,1,2,2,7
"NW_020169006.1 Populus trichocarpa isolate Nisqually-1 unplaced genomic scaffold, Pop_tri_v3 scaffold_2862, whole genome shotgun sequence",4287,8,0,5,6,19
"NW_020169007.1 Populus trichocarpa isolate Nisqually-1 unplaced genomic scaffold, Pop_tri_v3 scaffold_2864, whole genome shotgun sequence",4118,7,6,5,8,26
"NW_020169008.1 Populus trichocarpa isolate Nisqually-1 unplaced genomic scaffold, Pop_tri_v3 scaffold_2868, whole genome shotgun sequence",2983,6,0,5,4,15
"NW_020169009.1 Populus trichocarpa isolate Nisqually-1 unplaced genomic scaffold, Pop_tri_v3 scaffold_2870, whole genome shotgun sequence",3514,17,1,12,17,47
"NW_020169010.1 Populus trichocarpa isolate Nisqually-1 unplaced genomic scaffold, Pop_tri_v3 scaffold_2874, whole genome shotgun sequence",3417,0,3,0,3,6
"NW_020169011.1 Populus trichocarpa isolate Nisqually-1 unplaced genomic scaffold, Pop_tri_v3 scaffold_2876, whole genome shotgun sequence",3807,5,0,0,7,12
"NW_020169012.1 Populus trichocarpa isolate Nisqually-1 unplaced genomic scaffold, Pop_tri_v3 scaffold_2879, whole genome shotgun sequence",2846,36,85,44,76,241
"NW_020169013.1 Populus trichocarpa isolate Nisqually-1 unplaced genomic scaffold, Pop_tri_v3 scaffold_2881, whole genome shotgun sequence",3313,12,9,13,14,48
"NW_020169014.1 Populus trichocarpa isolate Nisqually-1 unplaced genomic scaffold, Pop_tri_v3 scaffold_2883, whole genome shotgun sequence",4123,27,12,25,29,93
"NW_020169015.1 Populus trichocarpa isolate Nisqually-1 unplaced genomic scaffold, Pop_tri_v3 scaffold_2885, whole genome shotgun sequence",2936,25,5,11,41,82
"NW_020169016.1 Populus trichocarpa isolate Nisqually-1 unplaced genomic scaffold, Pop_tri_v3 scaffold_2889, whole genome shotgun sequence",2826,26,10,12,34,82
"NW_020169017.1 Populus trichocarpa isolate Nisqually-1 unplaced genomic scaffold, Pop_tri_v3 scaffold_2890, whole genome shotgun sequence",4055,1,0,1,1,3
"NW_020169018.1 Populus trichocarpa isolate Nisqually-1 unplaced genomic scaffold, Pop_tri_v3 scaffold_2891, whole genome shotgun sequence",5258,10,3,1,4,18
"NW_020169019.1 Populus trichocarpa isolate Nisqually-1 unplaced genomic scaffold, Pop_tri_v3 scaffold_2893, whole genome shotgun sequence",2797,54,64,31,52,201
"NW_020169020.1 Populus trichocarpa isolate Nisqually-1 unplaced genomic scaffold, Pop_tri_v3 scaffold_2907, whole genome shotgun sequence",2749,0,0,0,0,0
"NW_020169021.1 Populus trichocarpa isolate Nisqually-1 unplaced genomic scaffold, Pop_tri_v3 scaffold_2908, whole genome shotgun sequence",3490,13,9,9,11,42
"NW_020169022.1 Populus trichocarpa isolate Nisqually-1 unplaced genomic scaffold, Pop_tri_v3 scaffold_2909, whole genome shotgun sequence",5618,3,0,5,4,12
"NW_020169023.1 Populus trichocarpa isolate Nisqually-1 unplaced genomic scaffold, Pop_tri_v3 scaffold_2910, whole genome shotgun sequence",3641,16,4,8,17,45
"NW_020169024.1 Populus trichocarpa isolate Nisqually-1 unplaced genomic scaffold, Pop_tri_v3 scaffold_2911, whole genome shotgun sequence",2734,30,8,17,17,72
"NW_020169025.1 Populus trichocarpa isolate Nisqually-1 unplaced genomic scaffold, Pop_tri_v3 scaffold_2912, whole genome shotgun sequence",3824,0,0,1,1,2
"NW_020169026.1 Populus trichocarpa isolate Nisqually-1 unplaced genomic scaffold, Pop_tri_v3 scaffold_2913, whole genome shotgun sequence",2832,10,1,1,3,15
"NW_020169027.1 Populus trichocarpa isolate Nisqually-1 unplaced genomic scaffold, Pop_tri_v3 scaffold_2914, whole genome shotgun sequence",3079,3,1,3,8,15
"NW_020169028.1 Populus trichocarpa isolate Nisqually-1 unplaced genomic scaffold, Pop_tri_v3 scaffold_2915, whole genome shotgun sequence",28062,2,4,2,2,10
"NW_020169029.1 Populus trichocarpa isolate Nisqually-1 unplaced genomic scaffold, Pop_tri_v3 scaffold_2916, whole genome shotgun sequence",3383,14,3,9,19,45
"NW_020169030.1 Populus trichocarpa isolate Nisqually-1 unplaced genomic scaffold, Pop_tri_v3 scaffold_2919, whole genome shotgun sequence",2717,4,2,2,8,16
"NW_020169031.1 Populus trichocarpa isolate Nisqually-1 unplaced genomic scaffold, Pop_tri_v3 scaffold_2921, whole genome shotgun sequence",3794,2,1,1,3,7
"NW_020169032.1 Populus trichocarpa isolate Nisqually-1 unplaced genomic scaffold, Pop_tri_v3 scaffold_2922, whole genome shotgun sequence",2707,1,1,1,3,6
"NW_020169033.1 Populus trichocarpa isolate Nisqually-1 unplaced genomic scaffold, Pop_tri_v3 scaffold_2923, whole genome shotgun sequence",4385,2,0,3,1,6
"NW_020169034.1 Populus trichocarpa isolate Nisqually-1 unplaced genomic scaffold, Pop_tri_v3 scaffold_2924, whole genome shotgun sequence",2704,3,0,0,4,7
"NW_020169035.1 Populus trichocarpa isolate Nisqually-1 unplaced genomic scaffold, Pop_tri_v3 scaffold_2925, whole genome shotgun sequence",3664,16,7,6,24,53
"NW_020169036.1 Populus trichocarpa isolate Nisqually-1 unplaced genomic scaffold, Pop_tri_v3 scaffold_2930, whole genome shotgun sequence",2674,10,2,5,16,33
"NW_020169037.1 Populus trichocarpa isolate Nisqually-1 unplaced genomic scaffold, Pop_tri_v3 scaffold_2932, whole genome shotgun sequence",3779,4,0,2,2,8
"NW_020169038.1 Populus trichocarpa isolate Nisqually-1 unplaced genomic scaffold, Pop_tri_v3 scaffold_2933, whole genome shotgun sequence",2669,11,5,8,14,38
"NW_020169039.1 Populus trichocarpa isolate Nisqually-1 unplaced genomic scaffold, Pop_tri_v3 scaffold_2934, whole genome shotgun sequence",3135,3,1,3,2,9
"NW_020169040.1 Populus trichocarpa isolate Nisqually-1 unplaced genomic scaffold, Pop_tri_v3 scaffold_2936, whole genome shotgun sequence",3635,2,0,2,6,10
"NW_020169041.1 Populus trichocarpa isolate Nisqually-1 unplaced genomic scaffold, Pop_tri_v3 scaffold_2939, whole genome shotgun sequence",3085,3,2,3,2,10
"NW_020169042.1 Populus trichocarpa isolate Nisqually-1 unplaced genomic scaffold, Pop_tri_v3 scaffold_2943, whole genome shotgun sequence",3514,20,9,13,27,69
"NW_020169043.1 Populus trichocarpa isolate Nisqually-1 unplaced genomic scaffold, Pop_tri_v3 scaffold_2947, whole genome shotgun sequence",3003,26,9,19,41,95
"NW_020169044.1 Populus trichocarpa isolate Nisqually-1 unplaced genomic scaffold, Pop_tri_v3 scaffold_2948, whole genome shotgun sequence",3699,13,9,11,31,64
"NW_020169045.1 Populus trichocarpa isolate Nisqually-1 unplaced genomic scaffold, Pop_tri_v3 scaffold_2949, whole genome shotgun sequence",4017,4,2,3,6,15
"NW_020169046.1 Populus trichocarpa isolate Nisqually-1 unplaced genomic scaffold, Pop_tri_v3 scaffold_2950, whole genome shotgun sequence",3093,1,2,1,2,6
"NW_020169047.1 Populus trichocarpa isolate Nisqually-1 unplaced genomic scaffold, Pop_tri_v3 scaffold_2951, whole genome shotgun sequence",2618,1,0,1,0,2
"NW_020169048.1 Populus trichocarpa isolate Nisqually-1 unplaced genomic scaffold, Pop_tri_v3 scaffold_2955, whole genome shotgun sequence",3779,6,11,8,7,32
"NW_020169049.1 Populus trichocarpa isolate Nisqually-1 unplaced genomic scaffold, Pop_tri_v3 scaffold_2957, whole genome shotgun sequence",3402,1,2,1,2,6
"NW_020169050.1 Populus trichocarpa isolate Nisqually-1 unplaced genomic scaffold, Pop_tri_v3 scaffold_2960, whole genome shotgun sequence",3795,30,1,15,33,79
"NW_020169051.1 Populus trichocarpa isolate Nisqually-1 unplaced genomic scaffold, Pop_tri_v3 scaffold_2962, whole genome shotgun sequence",7411,0,0,0,0,0
"NW_020169052.1 Populus trichocarpa isolate Nisqually-1 unplaced genomic scaffold, Pop_tri_v3 scaffold_2965, whole genome shotgun sequence",2576,20,9,10,30,69
"NW_020169053.1 Populus trichocarpa isolate Nisqually-1 unplaced genomic scaffold, Pop_tri_v3 scaffold_2967, whole genome shotgun sequence",3545,1,1,0,2,4
"NW_020169054.1 Populus trichocarpa isolate Nisqually-1 unplaced genomic scaffold, Pop_tri_v3 scaffold_2968, whole genome shotgun sequence",2573,11,6,5,13,35
"NW_020169055.1 Populus trichocarpa isolate Nisqually-1 unplaced genomic scaffold, Pop_tri_v3 scaffold_2971, whole genome shotgun sequence",3740,26,5,11,37,79
"NW_020169056.1 Populus trichocarpa isolate Nisqually-1 unplaced genomic scaffold, Pop_tri_v3 scaffold_2974, whole genome shotgun sequence",3366,7,1,3,8,19
"NW_020169057.1 Populus trichocarpa isolate Nisqually-1 unplaced genomic scaffold, Pop_tri_v3 scaffold_2975, whole genome shotgun sequence",3810,23,7,12,44,86
"NW_020169058.1 Populus trichocarpa isolate Nisqually-1 unplaced genomic scaffold, Pop_tri_v3 scaffold_2977, whole genome shotgun sequence",4407,12,8,16,13,49
"NW_020169059.1 Populus trichocarpa isolate Nisqually-1 unplaced genomic scaffold, Pop_tri_v3 scaffold_2979, whole genome shotgun sequence",3297,15,5,9,17,46
"NW_020169060.1 Populus trichocarpa isolate Nisqually-1 unplaced genomic scaffold, Pop_tri_v3 scaffold_2981, whole genome shotgun sequence",2544,50,65,38,61,214
"NW_020169061.1 Populus trichocarpa isolate Nisqually-1 unplaced genomic scaffold, Pop_tri_v3 scaffold_2987, whole genome shotgun sequence",2534,10,6,9,21,46
"NW_020169062.1 Populus trichocarpa isolate Nisqually-1 unplaced genomic scaffold, Pop_tri_v3 scaffold_2992, whole genome shotgun sequence",3306,35,8,20,42,105
"NW_020169063.1 Populus trichocarpa isolate Nisqually-1 unplaced genomic scaffold, Pop_tri_v3 scaffold_2998, whole genome shotgun sequence",3938,11,5,5,18,39
"NW_020169064.1 Populus trichocarpa isolate Nisqually-1 unplaced genomic scaffold, Pop_tri_v3 scaffold_3001, whole genome shotgun sequence",3003,17,7,10,18,52
"NW_020169065.1 Populus trichocarpa isolate Nisqually-1 unplaced genomic scaffold, Pop_tri_v3 scaffold_3002, whole genome shotgun sequence",10217,1,4,1,3,9
"NW_020169066.1 Populus trichocarpa isolate Nisqually-1 unplaced genomic scaffold, Pop_tri_v3 scaffold_3003, whole genome shotgun sequence",3052,21,4,16,16,57
"NW_020169067.1 Populus trichocarpa isolate Nisqually-1 unplaced genomic scaffold, Pop_tri_v3 scaffold_3005, whole genome shotgun sequence",2485,0,0,0,1,1
"NW_020169068.1 Populus trichocarpa isolate Nisqually-1 unplaced genomic scaffold, Pop_tri_v3 scaffold_3006, whole genome shotgun sequence",4012,1,0,0,0,1
"NW_020169069.1 Populus trichocarpa isolate Nisqually-1 unplaced genomic scaffold, Pop_tri_v3 scaffold_3007, whole genome shotgun sequence",2593,0,1,1,0,2
"NW_020169070.1 Populus trichocarpa isolate Nisqually-1 unplaced genomic scaffold, Pop_tri_v3 scaffold_3008, whole genome shotgun sequence",2908,4,6,0,0,10
"NW_020169071.1 Populus trichocarpa isolate Nisqually-1 unplaced genomic scaffold, Pop_tri_v3 scaffold_3011, whole genome shotgun sequence",2971,2,3,0,2,7
"NW_020169072.1 Populus trichocarpa isolate Nisqually-1 unplaced genomic scaffold, Pop_tri_v3 scaffold_3013, whole genome shotgun sequence",3185,14,4,8,16,42
"NW_020169073.1 Populus trichocarpa isolate Nisqually-1 unplaced genomic scaffold, Pop_tri_v3 scaffold_3014, whole genome shotgun sequence",2633,13,6,7,20,46
"NW_020169074.1 Populus trichocarpa isolate Nisqually-1 unplaced genomic scaffold, Pop_tri_v3 scaffold_3015, whole genome shotgun sequence",3590,3,2,0,3,8
"NW_020169075.1 Populus trichocarpa isolate Nisqually-1 unplaced genomic scaffold, Pop_tri_v3 scaffold_3019, whole genome shotgun sequence",5693,0,0,0,0,0
"NW_020169076.1 Populus trichocarpa isolate Nisqually-1 unplaced genomic scaffold, Pop_tri_v3 scaffold_3020, whole genome shotgun sequence",2530,5,0,3,4,12
"NW_020169077.1 Populus trichocarpa isolate Nisqually-1 unplaced genomic scaffold, Pop_tri_v3 scaffold_3021, whole genome shotgun sequence",2419,1,2,1,3,7
"NW_020169078.1 Populus trichocarpa isolate Nisqually-1 unplaced genomic scaffold, Pop_tri_v3 scaffold_3024, whole genome shotgun sequence",2408,4,2,2,0,8
"NW_020169079.1 Populus trichocarpa isolate Nisqually-1 unplaced genomic scaffold, Pop_tri_v3 scaffold_3025, whole genome shotgun sequence",3271,15,6,11,33,65
"NW_020169080.1 Populus trichocarpa isolate Nisqually-1 unplaced genomic scaffold, Pop_tri_v3 scaffold_3026, whole genome shotgun sequence",3549,1,2,2,6,11
"NW_020169081.1 Populus trichocarpa isolate Nisqually-1 unplaced genomic scaffold, Pop_tri_v3 scaffold_3030, whole genome shotgun sequence",3553,0,1,0,1,2
"NW_020169082.1 Populus trichocarpa isolate Nisqually-1 unplaced genomic scaffold, Pop_tri_v3 scaffold_3031, whole genome shotgun sequence",8870,1,2,2,0,5
"NW_020169083.1 Populus trichocarpa isolate Nisqually-1 unplaced genomic scaffold, Pop_tri_v3 scaffold_3032, whole genome shotgun sequence",2391,6,3,7,2,18
"NW_020169084.1 Populus trichocarpa isolate Nisqually-1 unplaced genomic scaffold, Pop_tri_v3 scaffold_3039, whole genome shotgun sequence",3951,0,0,0,1,1
"NW_020169085.1 Populus trichocarpa isolate Nisqually-1 unplaced genomic scaffold, Pop_tri_v3 scaffold_3040, whole genome shotgun sequence",3913,13,7,11,23,54
"NW_020169086.1 Populus trichocarpa isolate Nisqually-1 unplaced genomic scaffold, Pop_tri_v3 scaffold_3041, whole genome shotgun sequence",2593,2,0,3,2,7
"NW_020169087.1 Populus trichocarpa isolate Nisqually-1 unplaced genomic scaffold, Pop_tri_v3 scaffold_3042, whole genome shotgun sequence",2357,4,5,1,8,18
"NW_020169088.1 Populus trichocarpa isolate Nisqually-1 unplaced genomic scaffold, Pop_tri_v3 scaffold_3044, whole genome shotgun sequence",2336,16,14,4,17,51
"NW_020169089.1 Populus trichocarpa isolate Nisqually-1 unplaced genomic scaffold, Pop_tri_v3 scaffold_3046, whole genome shotgun sequence",2329,6,8,1,5,20
"NW_020169090.1 Populus trichocarpa isolate Nisqually-1 unplaced genomic scaffold, Pop_tri_v3 scaffold_3049, whole genome shotgun sequence",3254,5,6,5,6,22
"NW_020169091.1 Populus trichocarpa isolate Nisqually-1 unplaced genomic scaffold, Pop_tri_v3 scaffold_3050, whole genome shotgun sequence",2317,5,5,0,13,23
"NW_020169092.1 Populus trichocarpa isolate Nisqually-1 unplaced genomic scaffold, Pop_tri_v3 scaffold_3053, whole genome shotgun sequence",2603,5,4,6,3,18
"NW_020169093.1 Populus trichocarpa isolate Nisqually-1 unplaced genomic scaffold, Pop_tri_v3 scaffold_3054, whole genome shotgun sequence",2300,0,1,0,0,1
"NW_020169094.1 Populus trichocarpa isolate Nisqually-1 unplaced genomic scaffold, Pop_tri_v3 scaffold_3055, whole genome shotgun sequence",2299,46,12,12,35,105
"NW_020169095.1 Populus trichocarpa isolate Nisqually-1 unplaced genomic scaffold, Pop_tri_v3 scaffold_3056, whole genome shotgun sequence",2299,4,3,2,2,11
"NW_020169096.1 Populus trichocarpa isolate Nisqually-1 unplaced genomic scaffold, Pop_tri_v3 scaffold_3058, whole genome shotgun sequence",2824,2,2,3,4,11
"NW_020169097.1 Populus trichocarpa isolate Nisqually-1 unplaced genomic scaffold, Pop_tri_v3 scaffold_3059, whole genome shotgun sequence",4720,11,11,5,18,45
"NW_020169098.1 Populus trichocarpa isolate Nisqually-1 unplaced genomic scaffold, Pop_tri_v3 scaffold_3060, whole genome shotgun sequence",2290,29,66,39,58,192
"NW_020169099.1 Populus trichocarpa isolate Nisqually-1 unplaced genomic scaffold, Pop_tri_v3 scaffold_3061, whole genome shotgun sequence",2903,1,2,4,3,10
"NW_020169100.1 Populus trichocarpa isolate Nisqually-1 unplaced genomic scaffold, Pop_tri_v3 scaffold_3064, whole genome shotgun sequence",2391,3,1,8,7,19
"NW_020169101.1 Populus trichocarpa isolate Nisqually-1 unplaced genomic scaffold, Pop_tri_v3 scaffold_3068, whole genome shotgun sequence",2254,6,1,2,9,18
"NW_020169102.1 Populus trichocarpa isolate Nisqually-1 unplaced genomic scaffold, Pop_tri_v3 scaffold_3074, whole genome shotgun sequence",2965,23,7,9,29,68
"NW_020169103.1 Populus trichocarpa isolate Nisqually-1 unplaced genomic scaffold, Pop_tri_v3 scaffold_3076, whole genome shotgun sequence",2214,4,2,3,6,15
"NW_020169104.1 Populus trichocarpa isolate Nisqually-1 unplaced genomic scaffold, Pop_tri_v3 scaffold_3079, whole genome shotgun sequence",3756,2,0,0,0,2
"NW_020169105.1 Populus trichocarpa isolate Nisqually-1 unplaced genomic scaffold, Pop_tri_v3 scaffold_3081, whole genome shotgun sequence",6635,3,0,0,1,4
"NW_020169106.1 Populus trichocarpa isolate Nisqually-1 unplaced genomic scaffold, Pop_tri_v3 scaffold_3087, whole genome shotgun sequence",3603,1,2,0,2,5
"NW_020169107.1 Populus trichocarpa isolate Nisqually-1 unplaced genomic scaffold, Pop_tri_v3 scaffold_3088, whole genome shotgun sequence",2159,2,0,2,4,8
"NW_020169108.1 Populus trichocarpa isolate Nisqually-1 unplaced genomic scaffold, Pop_tri_v3 scaffold_3090, whole genome shotgun sequence",3391,3,2,2,7,14
"NW_020169109.1 Populus trichocarpa isolate Nisqually-1 unplaced genomic scaffold, Pop_tri_v3 scaffold_3092, whole genome shotgun sequence",4949,0,0,0,0,0
"NW_020169110.1 Populus trichocarpa isolate Nisqually-1 unplaced genomic scaffold, Pop_tri_v3 scaffold_3095, whole genome shotgun sequence",2137,29,56,28,44,157
"NW_020169111.1 Populus trichocarpa isolate Nisqually-1 unplaced genomic scaffold, Pop_tri_v3 scaffold_3096, whole genome shotgun sequence",3579,3,3,0,2,8
"NW_020169112.1 Populus trichocarpa isolate Nisqually-1 unplaced genomic scaffold, Pop_tri_v3 scaffold_3097, whole genome shotgun sequence",3242,12,3,4,17,36
"NW_020169113.1 Populus trichocarpa isolate Nisqually-1 unplaced genomic scaffold, Pop_tri_v3 scaffold_3100, whole genome shotgun sequence",2123,4,1,1,6,12
"NW_020169114.1 Populus trichocarpa isolate Nisqually-1 unplaced genomic scaffold, Pop_tri_v3 scaffold_3101, whole genome shotgun sequence",8550,3,4,3,2,12
"NW_020169115.1 Populus trichocarpa isolate Nisqually-1 unplaced genomic scaffold, Pop_tri_v3 scaffold_3102, whole genome shotgun sequence",3303,2,0,1,1,4
"NW_020169116.1 Populus trichocarpa isolate Nisqually-1 unplaced genomic scaffold, Pop_tri_v3 scaffold_3103, whole genome shotgun sequence",2114,3,8,11,5,27
"NW_020169117.1 Populus trichocarpa isolate Nisqually-1 unplaced genomic scaffold, Pop_tri_v3 scaffold_3107, whole genome shotgun sequence",2869,1,1,4,2,8
"NW_020169118.1 Populus trichocarpa isolate Nisqually-1 unplaced genomic scaffold, Pop_tri_v3 scaffold_3109, whole genome shotgun sequence",8310,2,0,7,7,16
"NW_020169119.1 Populus trichocarpa isolate Nisqually-1 unplaced genomic scaffold, Pop_tri_v3 scaffold_3112, whole genome shotgun sequence",3277,2,1,2,3,8
"NW_020169120.1 Populus trichocarpa isolate Nisqually-1 unplaced genomic scaffold, Pop_tri_v3 scaffold_3115, whole genome shotgun sequence",4603,7,2,5,4,18
"NW_020169121.1 Populus trichocarpa isolate Nisqually-1 unplaced genomic scaffold, Pop_tri_v3 scaffold_3116, whole genome shotgun sequence",2637,5,4,0,8,17
"NW_020169122.1 Populus trichocarpa isolate Nisqually-1 unplaced genomic scaffold, Pop_tri_v3 scaffold_3117, whole genome shotgun sequence",5170,3,2,2,3,10
"NW_020169123.1 Populus trichocarpa isolate Nisqually-1 unplaced genomic scaffold, Pop_tri_v3 scaffold_3119, whole genome shotgun sequence",8145,2,2,1,3,8
"NW_020169124.1 Populus trichocarpa isolate Nisqually-1 unplaced genomic scaffold, Pop_tri_v3 scaffold_3121, whole genome shotgun sequence",2043,30,58,27,62,177
"NW_020169125.1 Populus trichocarpa isolate Nisqually-1 unplaced genomic scaffold, Pop_tri_v3 scaffold_3123, whole genome shotgun sequence",2033,5,2,3,6,16
"NW_020169126.1 Populus trichocarpa isolate Nisqually-1 unplaced genomic scaffold, Pop_tri_v3 scaffold_3124, whole genome shotgun sequence",6568,4,2,3,2,11
"NW_020169127.1 Populus trichocarpa isolate Nisqually-1 unplaced genomic scaffold, Pop_tri_v3 scaffold_3126, whole genome shotgun sequence",2028,3,1,0,0,4
"NW_020169128.1 Populus trichocarpa isolate Nisqually-1 unplaced genomic scaffold, Pop_tri_v3 scaffold_3127, whole genome shotgun sequence",4070,2,0,1,0,3
"NW_020169129.1 Populus trichocarpa isolate Nisqually-1 unplaced genomic scaffold, Pop_tri_v3 scaffold_3129, whole genome shotgun sequence",2114,7,4,4,3,18
"NW_020169130.1 Populus trichocarpa isolate Nisqually-1 unplaced genomic scaffold, Pop_tri_v3 scaffold_3134, whole genome shotgun sequence",2599,7,7,2,8,24
"NW_020169131.1 Populus trichocarpa isolate Nisqually-1 unplaced genomic scaffold, Pop_tri_v3 scaffold_3135, whole genome shotgun sequence",6143,1,1,1,2,5
"NW_020169132.1 Populus trichocarpa isolate Nisqually-1 unplaced genomic scaffold, Pop_tri_v3 scaffold_3136, whole genome shotgun sequence",2710,1,0,1,0,2
"NW_020169133.1 Populus trichocarpa isolate Nisqually-1 unplaced genomic scaffold, Pop_tri_v3 scaffold_3139, whole genome shotgun sequence",1964,32,51,27,21,131
"NW_020169134.1 Populus trichocarpa isolate Nisqually-1 unplaced genomic scaffold, Pop_tri_v3 scaffold_3142, whole genome shotgun sequence",4361,2,5,2,2,11
"NW_020169135.1 Populus trichocarpa isolate Nisqually-1 unplaced genomic scaffold, Pop_tri_v3 scaffold_3147, whole genome shotgun sequence",2230,3,1,2,3,9
"NW_020169136.1 Populus trichocarpa isolate Nisqually-1 unplaced genomic scaffold, Pop_tri_v3 scaffold_3149, whole genome shotgun sequence",3718,1,3,1,7,12
"NW_020169137.1 Populus trichocarpa isolate Nisqually-1 unplaced genomic scaffold, Pop_tri_v3 scaffold_3156, whole genome shotgun sequence",4647,2,1,1,0,4
"NW_020169138.1 Populus trichocarpa isolate Nisqually-1 unplaced genomic scaffold, Pop_tri_v3 scaffold_3157, whole genome shotgun sequence",1898,9,4,4,16,33
"NW_020169139.1 Populus trichocarpa isolate Nisqually-1 unplaced genomic scaffold, Pop_tri_v3 scaffold_3160, whole genome shotgun sequence",1884,8,3,4,10,25
"NW_020169140.1 Populus trichocarpa isolate Nisqually-1 unplaced genomic scaffold, Pop_tri_v3 scaffold_3164, whole genome shotgun sequence",7758,0,2,2,2,6
"NW_020169141.1 Populus trichocarpa isolate Nisqually-1 unplaced genomic scaffold, Pop_tri_v3 scaffold_3168, whole genome shotgun sequence",3167,26,13,11,23,73
"NW_020169142.1 Populus trichocarpa isolate Nisqually-1 unplaced genomic scaffold, Pop_tri_v3 scaffold_3171, whole genome shotgun sequence",1840,5,4,5,5,19
"NW_020169143.1 Populus trichocarpa isolate Nisqually-1 unplaced genomic scaffold, Pop_tri_v3 scaffold_3177, whole genome shotgun sequence",3566,9,1,4,5,19
"NW_020169144.1 Populus trichocarpa isolate Nisqually-1 unplaced genomic scaffold, Pop_tri_v3 scaffold_3179, whole genome shotgun sequence",2709,2,0,4,3,9
"NW_020169145.1 Populus trichocarpa isolate Nisqually-1 unplaced genomic scaffold, Pop_tri_v3 scaffold_3183, whole genome shotgun sequence",3595,2,3,4,4,13
"NW_020169146.1 Populus trichocarpa isolate Nisqually-1 unplaced genomic scaffold, Pop_tri_v3 scaffold_3186, whole genome shotgun sequence",3306,17,11,14,31,73
"NW_020169147.1 Populus trichocarpa isolate Nisqually-1 unplaced genomic scaffold, Pop_tri_v3 scaffold_3188, whole genome shotgun sequence",4681,3,0,3,0,6
"NW_020169148.1 Populus trichocarpa isolate Nisqually-1 unplaced genomic scaffold, Pop_tri_v3 scaffold_3189, whole genome shotgun sequence",8023,2,6,4,9,21
"NW_020169149.1 Populus trichocarpa isolate Nisqually-1 unplaced genomic scaffold, Pop_tri_v3 scaffold_3190, whole genome shotgun sequence",1726,4,6,2,6,18
"NW_020169150.1 Populus trichocarpa isolate Nisqually-1 unplaced genomic scaffold, Pop_tri_v3 scaffold_3191, whole genome shotgun sequence",2934,1,3,0,1,5
"NW_020169151.1 Populus trichocarpa isolate Nisqually-1 unplaced genomic scaffold, Pop_tri_v3 scaffold_3194, whole genome shotgun sequence",2061,3,2,2,4,11
"NW_020169152.1 Populus trichocarpa isolate Nisqually-1 unplaced genomic scaffold, Pop_tri_v3 scaffold_3195, whole genome shotgun sequence",4011,3,2,3,1,9
"NW_020169153.1 Populus trichocarpa isolate Nisqually-1 unplaced genomic scaffold, Pop_tri_v3 scaffold_3202, whole genome shotgun sequence",2247,3,0,1,2,6
"NW_020169154.1 Populus trichocarpa isolate Nisqually-1 unplaced genomic scaffold, Pop_tri_v3 scaffold_3205, whole genome shotgun sequence",3285,0,1,0,0,1
"NW_020169155.1 Populus trichocarpa isolate Nisqually-1 unplaced genomic scaffold, Pop_tri_v3 scaffold_3206, whole genome shotgun sequence",1669,1,0,2,1,4
"NW_020169156.1 Populus trichocarpa isolate Nisqually-1 unplaced genomic scaffold, Pop_tri_v3 scaffold_3210, whole genome shotgun sequence",1863,0,0,0,0,0
"NW_020169157.1 Populus trichocarpa isolate Nisqually-1 unplaced genomic scaffold, Pop_tri_v3 scaffold_3212, whole genome shotgun sequence",3752,4,0,3,12,19
"NW_020169158.1 Populus trichocarpa isolate Nisqually-1 unplaced genomic scaffold, Pop_tri_v3 scaffold_3213, whole genome shotgun sequence",1653,0,0,0,0,0
"NW_020169159.1 Populus trichocarpa isolate Nisqually-1 unplaced genomic scaffold, Pop_tri_v3 scaffold_3214, whole genome shotgun sequence",1641,10,1,6,9,26
"NW_020169160.1 Populus trichocarpa isolate Nisqually-1 unplaced genomic scaffold, Pop_tri_v3 scaffold_3221, whole genome shotgun sequence",3534,0,1,0,0,1
"NW_020169161.1 Populus trichocarpa isolate Nisqually-1 unplaced genomic scaffold, Pop_tri_v3 scaffold_3222, whole genome shotgun sequence",1606,0,2,1,2,5
"NW_020169162.1 Populus trichocarpa isolate Nisqually-1 unplaced genomic scaffold, Pop_tri_v3 scaffold_3223, whole genome shotgun sequence",1705,1,1,0,0,2
"NW_020169163.1 Populus trichocarpa isolate Nisqually-1 unplaced genomic scaffold, Pop_tri_v3 scaffold_3226, whole genome shotgun sequence",1920,0,0,0,0,0
"NW_020169164.1 Populus trichocarpa isolate Nisqually-1 unplaced genomic scaffold, Pop_tri_v3 scaffold_3227, whole genome shotgun sequence",6756,0,1,0,2,3
"NW_020169165.1 Populus trichocarpa isolate Nisqually-1 unplaced genomic scaffold, Pop_tri_v3 scaffold_3228, whole genome shotgun sequence",1597,30,5,19,16,70
"NW_020169166.1 Populus trichocarpa isolate Nisqually-1 unplaced genomic scaffold, Pop_tri_v3 scaffold_3230, whole genome shotgun sequence",1594,0,0,2,1,3
"NW_020169167.1 Populus trichocarpa isolate Nisqually-1 unplaced genomic scaffold, Pop_tri_v3 scaffold_3231, whole genome shotgun sequence",1591,1,0,0,1,2
"NW_020169168.1 Populus trichocarpa isolate Nisqually-1 unplaced genomic scaffold, Pop_tri_v3 scaffold_3236, whole genome shotgun sequence",1544,16,1,9,15,41
"NW_020169169.1 Populus trichocarpa isolate Nisqually-1 unplaced genomic scaffold, Pop_tri_v3 scaffold_3239, whole genome shotgun sequence",1965,0,0,0,0,0
"NW_020169170.1 Populus trichocarpa isolate Nisqually-1 unplaced genomic scaffold, Pop_tri_v3 scaffold_3245, whole genome shotgun sequence",2263,7,4,3,8,22
"NW_020169171.1 Populus trichocarpa isolate Nisqually-1 unplaced genomic scaffold, Pop_tri_v3 scaffold_3246, whole genome shotgun sequence",1501,11,9,9,17,46
"NW_020169172.1 Populus trichocarpa isolate Nisqually-1 unplaced genomic scaffold, Pop_tri_v3 scaffold_3250, whole genome shotgun sequence",1485,0,0,1,2,3
"NW_020169173.1 Populus trichocarpa isolate Nisqually-1 unplaced genomic scaffold, Pop_tri_v3 scaffold_3251, whole genome shotgun sequence",2376,5,1,1,2,9
"NW_020169174.1 Populus trichocarpa isolate Nisqually-1 unplaced genomic scaffold, Pop_tri_v3 scaffold_3252, whole genome shotgun sequence",1483,1,6,0,1,8
"NW_020169175.1 Populus trichocarpa isolate Nisqually-1 unplaced genomic scaffold, Pop_tri_v3 scaffold_3254, whole genome shotgun sequence",1702,0,5,0,1,6
"NW_020169176.1 Populus trichocarpa isolate Nisqually-1 unplaced genomic scaffold, Pop_tri_v3 scaffold_3255, whole genome shotgun sequence",2564,0,1,0,2,3
"NW_020169177.1 Populus trichocarpa isolate Nisqually-1 unplaced genomic scaffold, Pop_tri_v3 scaffold_3257, whole genome shotgun sequence",1463,7,3,7,23,40
"NW_020169178.1 Populus trichocarpa isolate Nisqually-1 unplaced genomic scaffold, Pop_tri_v3 scaffold_3259, whole genome shotgun sequence",1665,0,1,0,0,1
"NW_020169179.1 Populus trichocarpa isolate Nisqually-1 unplaced genomic scaffold, Pop_tri_v3 scaffold_3262, whole genome shotgun sequence",1448,8,2,7,20,37
"NW_020169180.1 Populus trichocarpa isolate Nisqually-1 unplaced genomic scaffold, Pop_tri_v3 scaffold_3263, whole genome shotgun sequence",1970,4,2,2,9,17
"NW_020169181.1 Populus trichocarpa isolate Nisqually-1 unplaced genomic scaffold, Pop_tri_v3 scaffold_3264, whole genome shotgun sequence",1441,3,0,0,8,11
"NW_020169182.1 Populus trichocarpa isolate Nisqually-1 unplaced genomic scaffold, Pop_tri_v3 scaffold_3268, whole genome shotgun sequence",3281,1,1,2,0,4
"NW_020169183.1 Populus trichocarpa isolate Nisqually-1 unplaced genomic scaffold, Pop_tri_v3 scaffold_3269, whole genome shotgun sequence",1431,0,2,1,3,6
"NW_020169184.1 Populus trichocarpa isolate Nisqually-1 unplaced genomic scaffold, Pop_tri_v3 scaffold_3271, whole genome shotgun sequence",4203,3,0,0,1,4
"NW_020169185.1 Populus trichocarpa isolate Nisqually-1 unplaced genomic scaffold, Pop_tri_v3 scaffold_3272, whole genome shotgun sequence",1426,0,4,3,1,8
"NW_020169186.1 Populus trichocarpa isolate Nisqually-1 unplaced genomic scaffold, Pop_tri_v3 scaffold_3275, whole genome shotgun sequence",1417,8,4,4,11,27
"NW_020169187.1 Populus trichocarpa isolate Nisqually-1 unplaced genomic scaffold, Pop_tri_v3 scaffold_3276, whole genome shotgun sequence",4169,1,3,0,0,4
"NW_020169188.1 Populus trichocarpa isolate Nisqually-1 unplaced genomic scaffold, Pop_tri_v3 scaffold_3279, whole genome shotgun sequence",3471,2,0,0,0,2
"NW_020169189.1 Populus trichocarpa isolate Nisqually-1 unplaced genomic scaffold, Pop_tri_v3 scaffold_3282, whole genome shotgun sequence",4162,1,0,1,1,3
"NW_020169190.1 Populus trichocarpa isolate Nisqually-1 unplaced genomic scaffold, Pop_tri_v3 scaffold_3283, whole genome shotgun sequence",3155,0,2,0,2,4
"NW_020169191.1 Populus trichocarpa isolate Nisqually-1 unplaced genomic scaffold, Pop_tri_v3 scaffold_3285, whole genome shotgun sequence",2448,1,1,1,2,5
"NW_020169192.1 Populus trichocarpa isolate Nisqually-1 unplaced genomic scaffold, Pop_tri_v3 scaffold_3289, whole genome shotgun sequence",2781,4,1,1,8,14
"NW_020169193.1 Populus trichocarpa isolate Nisqually-1 unplaced genomic scaffold, Pop_tri_v3 scaffold_3290, whole genome shotgun sequence",33746,0,2,0,1,3
"NW_020169194.1 Populus trichocarpa isolate Nisqually-1 unplaced genomic scaffold, Pop_tri_v3 scaffold_3292, whole genome shotgun sequence",1613,1,1,1,0,3
"NW_020169195.1 Populus trichocarpa isolate Nisqually-1 unplaced genomic scaffold, Pop_tri_v3 scaffold_3294, whole genome shotgun sequence",1369,21,19,18,21,79
"NW_020169196.1 Populus trichocarpa isolate Nisqually-1 unplaced genomic scaffold, Pop_tri_v3 scaffold_3296, whole genome shotgun sequence",1362,0,0,0,0,0
"NW_020169197.1 Populus trichocarpa isolate Nisqually-1 unplaced genomic scaffold, Pop_tri_v3 scaffold_3298, whole genome shotgun sequence",2443,1,1,0,2,4
"NW_020169198.1 Populus trichocarpa isolate Nisqually-1 unplaced genomic scaffold, Pop_tri_v3 scaffold_3300, whole genome shotgun sequence",2080,0,0,1,3,4
"NW_020169199.1 Populus trichocarpa isolate Nisqually-1 unplaced genomic scaffold, Pop_tri_v3 scaffold_3301, whole genome shotgun sequence",5670,0,4,0,2,6
"NW_020169200.1 Populus trichocarpa isolate Nisqually-1 unplaced genomic scaffold, Pop_tri_v3 scaffold_3302, whole genome shotgun sequence",5537,1,2,1,0,4
"NW_020169201.1 Populus trichocarpa isolate Nisqually-1 unplaced genomic scaffold, Pop_tri_v3 scaffold_3304, whole genome shotgun sequence",1992,4,1,9,11,25
"NW_020169202.1 Populus trichocarpa isolate Nisqually-1 unplaced genomic scaffold, Pop_tri_v3 scaffold_3305, whole genome shotgun sequence",1337,1,1,1,1,4
"NW_020169203.1 Populus trichocarpa isolate Nisqually-1 unplaced genomic scaffold, Pop_tri_v3 scaffold_3306, whole genome shotgun sequence",1470,0,2,0,3,5
"NW_020169204.1 Populus trichocarpa isolate Nisqually-1 unplaced genomic scaffold, Pop_tri_v3 scaffold_3312, whole genome shotgun sequence",1324,8,8,6,10,32
"NW_020169205.1 Populus trichocarpa isolate Nisqually-1 unplaced genomic scaffold, Pop_tri_v3 scaffold_3316, whole genome shotgun sequence",1314,2,1,2,3,8
"NW_020169206.1 Populus trichocarpa isolate Nisqually-1 unplaced genomic scaffold, Pop_tri_v3 scaffold_3320, whole genome shotgun sequence",2574,0,1,0,3,4
"NW_020169207.1 Populus trichocarpa isolate Nisqually-1 unplaced genomic scaffold, Pop_tri_v3 scaffold_3324, whole genome shotgun sequence",3402,0,0,0,0,0
"NW_020169208.1 Populus trichocarpa isolate Nisqually-1 unplaced genomic scaffold, Pop_tri_v3 scaffold_3325, whole genome shotgun sequence",1298,2,2,1,1,6
"NW_020169209.1 Populus trichocarpa isolate Nisqually-1 unplaced genomic scaffold, Pop_tri_v3 scaffold_3326, whole genome shotgun sequence",2466,0,1,1,1,3
"NW_020169210.1 Populus trichocarpa isolate Nisqually-1 unplaced genomic scaffold, Pop_tri_v3 scaffold_3328, whole genome shotgun sequence",1293,1,0,0,1,2
"NW_020169211.1 Populus trichocarpa isolate Nisqually-1 unplaced genomic scaffold, Pop_tri_v3 scaffold_3332, whole genome shotgun sequence",1283,2,1,1,0,4
"NW_020169212.1 Populus trichocarpa isolate Nisqually-1 unplaced genomic scaffold, Pop_tri_v3 scaffold_3335, whole genome shotgun sequence",1924,1,0,0,0,1
"NW_020169213.1 Populus trichocarpa isolate Nisqually-1 unplaced genomic scaffold, Pop_tri_v3 scaffold_3336, whole genome shotgun sequence",7874,2,0,5,4,11
"NW_020169214.1 Populus trichocarpa isolate Nisqually-1 unplaced genomic scaffold, Pop_tri_v3 scaffold_3338, whole genome shotgun sequence",8082,0,0,0,1,1
"NW_020169215.1 Populus trichocarpa isolate Nisqually-1 unplaced genomic scaffold, Pop_tri_v3 scaffold_3340, whole genome shotgun sequence",2888,1,2,2,1,6
"NW_020169216.1 Populus trichocarpa isolate Nisqually-1 unplaced genomic scaffold, Pop_tri_v3 scaffold_3342, whole genome shotgun sequence",2686,4,2,0,1,7
"NW_020169217.1 Populus trichocarpa isolate Nisqually-1 unplaced genomic scaffold, Pop_tri_v3 scaffold_3344, whole genome shotgun sequence",8279,0,1,0,3,4
"NW_020169218.1 Populus trichocarpa isolate Nisqually-1 unplaced genomic scaffold, Pop_tri_v3 scaffold_3345, whole genome shotgun sequence",3576,10,5,5,0,20
"NW_020169219.1 Populus trichocarpa isolate Nisqually-1 unplaced genomic scaffold, Pop_tri_v3 scaffold_3346, whole genome shotgun sequence",1260,12,0,5,17,34
"NW_020169220.1 Populus trichocarpa isolate Nisqually-1 unplaced genomic scaffold, Pop_tri_v3 scaffold_3348, whole genome shotgun sequence",1258,10,1,2,11,24
"NW_020169221.1 Populus trichocarpa isolate Nisqually-1 unplaced genomic scaffold, Pop_tri_v3 scaffold_3352, whole genome shotgun sequence",2879,2,2,1,2,7
"NW_020169222.1 Populus trichocarpa isolate Nisqually-1 unplaced genomic scaffold, Pop_tri_v3 scaffold_3353, whole genome shotgun sequence",1243,0,0,0,0,0
"NW_020169223.1 Populus trichocarpa isolate Nisqually-1 unplaced genomic scaffold, Pop_tri_v3 scaffold_3354, whole genome shotgun sequence",2537,0,0,0,0,0
"NW_020169224.1 Populus trichocarpa isolate Nisqually-1 unplaced genomic scaffold, Pop_tri_v3 scaffold_3356, whole genome shotgun sequence",2921,5,1,2,4,12
"NW_020169225.1 Populus trichocarpa isolate Nisqually-1 unplaced genomic scaffold, Pop_tri_v3 scaffold_3357, whole genome shotgun sequence",1239,4,1,0,2,7
"NW_020169226.1 Populus trichocarpa isolate Nisqually-1 unplaced genomic scaffold, Pop_tri_v3 scaffold_3360, whole genome shotgun sequence",1235,1,1,2,1,5
"NW_020169227.1 Populus trichocarpa isolate Nisqually-1 unplaced genomic scaffold, Pop_tri_v3 scaffold_3362, whole genome shotgun sequence",1482,1,0,0,0,1
"NW_020169228.1 Populus trichocarpa isolate Nisqually-1 unplaced genomic scaffold, Pop_tri_v3 scaffold_3363, whole genome shotgun sequence",1230,0,2,2,3,7
"NW_020169229.1 Populus trichocarpa isolate Nisqually-1 unplaced genomic scaffold, Pop_tri_v3 scaffold_3364, whole genome shotgun sequence",2412,1,0,0,0,1
"NW_020169230.1 Populus trichocarpa isolate Nisqually-1 unplaced genomic scaffold, Pop_tri_v3 scaffold_3367, whole genome shotgun sequence",15621,0,2,0,1,3
"NW_020169231.1 Populus trichocarpa isolate Nisqually-1 unplaced genomic scaffold, Pop_tri_v3 scaffold_3368, whole genome shotgun sequence",1220,2,0,0,1,3
"NW_020169232.1 Populus trichocarpa isolate Nisqually-1 unplaced genomic scaffold, Pop_tri_v3 scaffold_3370, whole genome shotgun sequence",2985,2,1,1,2,6
"NW_020169233.1 Populus trichocarpa isolate Nisqually-1 unplaced genomic scaffold, Pop_tri_v3 scaffold_3372, whole genome shotgun sequence",1208,1,1,0,1,3
"NW_020169234.1 Populus trichocarpa isolate Nisqually-1 unplaced genomic scaffold, Pop_tri_v3 scaffold_3374, whole genome shotgun sequence",1200,1,0,1,2,4
"NW_020169235.1 Populus trichocarpa isolate Nisqually-1 unplaced genomic scaffold, Pop_tri_v3 scaffold_3378, whole genome shotgun sequence",5604,0,0,1,1,2
"NW_020169236.1 Populus trichocarpa isolate Nisqually-1 unplaced genomic scaffold, Pop_tri_v3 scaffold_3379, whole genome shotgun sequence",1639,2,0,0,0,2
"NW_020169237.1 Populus trichocarpa isolate Nisqually-1 unplaced genomic scaffold, Pop_tri_v3 scaffold_3381, whole genome shotgun sequence",1181,5,4,1,2,12
"NW_020169238.1 Populus trichocarpa isolate Nisqually-1 unplaced genomic scaffold, Pop_tri_v3 scaffold_3382, whole genome shotgun sequence",3799,2,0,1,0,3
"NW_020169239.1 Populus trichocarpa isolate Nisqually-1 unplaced genomic scaffold, Pop_tri_v3 scaffold_3383, whole genome shotgun sequence",1162,0,2,2,1,5
"NW_020169240.1 Populus trichocarpa isolate Nisqually-1 unplaced genomic scaffold, Pop_tri_v3 scaffold_3384, whole genome shotgun sequence",2287,0,0,1,2,3
"NW_020169241.1 Populus trichocarpa isolate Nisqually-1 unplaced genomic scaffold, Pop_tri_v3 scaffold_3386, whole genome shotgun sequence",4710,0,0,0,0,0
"NW_020169242.1 Populus trichocarpa isolate Nisqually-1 unplaced genomic scaffold, Pop_tri_v3 scaffold_3387, whole genome shotgun sequence",1156,3,4,3,3,13
"NW_020169243.1 Populus trichocarpa isolate Nisqually-1 unplaced genomic scaffold, Pop_tri_v3 scaffold_3388, whole genome shotgun sequence",1155,1,2,2,6,11
"NW_020169244.1 Populus trichocarpa isolate Nisqually-1 unplaced genomic scaffold, Pop_tri_v3 scaffold_3389, whole genome shotgun sequence",1153,1,4,3,4,12
"NW_020169245.1 Populus trichocarpa isolate Nisqually-1 unplaced genomic scaffold, Pop_tri_v3 scaffold_3391, whole genome shotgun sequence",1147,2,0,2,2,6
"NW_020169246.1 Populus trichocarpa isolate Nisqually-1 unplaced genomic scaffold, Pop_tri_v3 scaffold_3393, whole genome shotgun sequence",1141,1,2,1,1,5
"NW_020169247.1 Populus trichocarpa isolate Nisqually-1 unplaced genomic scaffold, Pop_tri_v3 scaffold_3397, whole genome shotgun sequence",6099,2,5,0,4,11
"NW_020169248.1 Populus trichocarpa isolate Nisqually-1 unplaced genomic scaffold, Pop_tri_v3 scaffold_3398, whole genome shotgun sequence",1131,3,0,2,0,5
"NW_020169249.1 Populus trichocarpa isolate Nisqually-1 unplaced genomic scaffold, Pop_tri_v3 scaffold_3403, whole genome shotgun sequence",2418,2,3,0,3,8
"NW_020169250.1 Populus trichocarpa isolate Nisqually-1 unplaced genomic scaffold, Pop_tri_v3 scaffold_3406, whole genome shotgun sequence",5718,0,2,0,0,2
"NW_020169251.1 Populus trichocarpa isolate Nisqually-1 unplaced genomic scaffold, Pop_tri_v3 scaffold_3411, whole genome shotgun sequence",5724,2,1,1,0,4
"NW_020169252.1 Populus trichocarpa isolate Nisqually-1 unplaced genomic scaffold, Pop_tri_v3 scaffold_3412, whole genome shotgun sequence",2813,2,1,2,3,8
"NW_020169253.1 Populus trichocarpa isolate Nisqually-1 unplaced genomic scaffold, Pop_tri_v3 scaffold_3413, whole genome shotgun sequence",1105,0,0,0,0,0
"NW_020169254.1 Populus trichocarpa isolate Nisqually-1 unplaced genomic scaffold, Pop_tri_v3 scaffold_3416, whole genome shotgun sequence",1094,0,0,0,0,0
"NW_020169255.1 Populus trichocarpa isolate Nisqually-1 unplaced genomic scaffold, Pop_tri_v3 scaffold_3420, whole genome shotgun sequence",8314,4,2,1,3,10
"NW_020169256.1 Populus trichocarpa isolate Nisqually-1 unplaced genomic scaffold, Pop_tri_v3 scaffold_3422, whole genome shotgun sequence",2139,3,4,1,1,9
"NW_020169257.1 Populus trichocarpa isolate Nisqually-1 unplaced genomic scaffold, Pop_tri_v3 scaffold_3423, whole genome shotgun sequence",1189,7,0,5,4,16
"NW_020169258.1 Populus trichocarpa isolate Nisqually-1 unplaced genomic scaffold, Pop_tri_v3 scaffold_3425, whole genome shotgun sequence",1075,0,1,2,6,9
"NW_020169259.1 Populus trichocarpa isolate Nisqually-1 unplaced genomic scaffold, Pop_tri_v3 scaffold_3426, whole genome shotgun sequence",1074,2,0,0,1,3
"NW_020169260.1 Populus trichocarpa isolate Nisqually-1 unplaced genomic scaffold, Pop_tri_v3 scaffold_3427, whole genome shotgun sequence",2622,1,1,2,3,7
"NW_020169261.1 Populus trichocarpa isolate Nisqually-1 unplaced genomic scaffold, Pop_tri_v3 scaffold_3430, whole genome shotgun sequence",1055,3,9,3,4,19
"NW_020169262.1 Populus trichocarpa isolate Nisqually-1 unplaced genomic scaffold, Pop_tri_v3 scaffold_3431, whole genome shotgun sequence",1055,1,0,1,0,2
"NW_020169263.1 Populus trichocarpa isolate Nisqually-1 unplaced genomic scaffold, Pop_tri_v3 scaffold_3432, whole genome shotgun sequence",1048,4,2,2,3,11
"NW_020169264.1 Populus trichocarpa isolate Nisqually-1 unplaced genomic scaffold, Pop_tri_v3 scaffold_3433, whole genome shotgun sequence",6343,2,1,2,3,8
"NW_020169265.1 Populus trichocarpa isolate Nisqually-1 unplaced genomic scaffold, Pop_tri_v3 scaffold_3436, whole genome shotgun sequence",2815,1,0,1,2,4
"NW_020169266.1 Populus trichocarpa isolate Nisqually-1 unplaced genomic scaffold, Pop_tri_v3 scaffold_3437, whole genome shotgun sequence",1040,0,0,0,0,0
"NW_020169267.1 Populus trichocarpa isolate Nisqually-1 unplaced genomic scaffold, Pop_tri_v3 scaffold_3440, whole genome shotgun sequence",1034,15,35,13,29,92
"NW_020169268.1 Populus trichocarpa isolate Nisqually-1 unplaced genomic scaffold, Pop_tri_v3 scaffold_3442, whole genome shotgun sequence",1032,22,1,4,13,40
"NW_020169269.1 Populus trichocarpa isolate Nisqually-1 unplaced genomic scaffold, Pop_tri_v3 scaffold_3445, whole genome shotgun sequence",1028,1,0,0,1,2
"NW_020169270.1 Populus trichocarpa isolate Nisqually-1 unplaced genomic scaffold, Pop_tri_v3 scaffold_3446, whole genome shotgun sequence",1027,1,0,0,3,4
"NW_020169271.1 Populus trichocarpa isolate Nisqually-1 unplaced genomic scaffold, Pop_tri_v3 scaffold_3448, whole genome shotgun sequence",1020,1,1,0,2,4
"NW_020169272.1 Populus trichocarpa isolate Nisqually-1 unplaced genomic scaffold, Pop_tri_v3 scaffold_3452, whole genome shotgun sequence",1858,1,1,0,1,3
"NW_020169273.1 Populus trichocarpa isolate Nisqually-1 unplaced genomic scaffold, Pop_tri_v3 scaffold_3453, whole genome shotgun sequence",1003,0,0,0,0,0
"NW_020169274.1 Populus trichocarpa isolate Nisqually-1 unplaced genomic scaffold, Pop_tri_v3 scaffold_3455, whole genome shotgun sequence",5697,0,0,2,2,4
"NW_020169275.1 Populus trichocarpa isolate Nisqually-1 unplaced genomic scaffold, Pop_tri_v3 scaffold_3459, whole genome shotgun sequence",5452,2,2,0,4,8
"NW_020169276.1 Populus trichocarpa isolate Nisqually-1 unplaced genomic scaffold, Pop_tri_v3 scaffold_3463, whole genome shotgun sequence",5000,0,1,0,4,5
"NW_020169277.1 Populus trichocarpa isolate Nisqually-1 unplaced genomic scaffold, Pop_tri_v3 scaffold_3464, whole genome shotgun sequence",5280,0,0,0,0,0
"NW_020169278.1 Populus trichocarpa isolate Nisqually-1 unplaced genomic scaffold, Pop_tri_v3 scaffold_3472, whole genome shotgun sequence",1331,1,0,2,1,4
"NW_020169279.1 Populus trichocarpa isolate Nisqually-1 unplaced genomic scaffold, Pop_tri_v3 scaffold_3474, whole genome shotgun sequence",1020,1,0,0,0,1
"NW_020169280.1 Populus trichocarpa isolate Nisqually-1 unplaced genomic scaffold, Pop_tri_v3 scaffold_3478, whole genome shotgun sequence",2690,1,0,0,0,1
"NW_020169281.1 Populus trichocarpa isolate Nisqually-1 unplaced genomic scaffold, Pop_tri_v3 scaffold_3479, whole genome shotgun sequence",6841,1,3,1,3,8
"NW_020169282.1 Populus trichocarpa isolate Nisqually-1 unplaced genomic scaffold, Pop_tri_v3 scaffold_3489, whole genome shotgun sequence",6432,1,1,1,2,5
"NW_020169283.1 Populus trichocarpa isolate Nisqually-1 unplaced genomic scaffold, Pop_tri_v3 scaffold_3505, whole genome shotgun sequence",3700,2,3,3,4,12
"NW_020169284.1 Populus trichocarpa isolate Nisqually-1 unplaced genomic scaffold, Pop_tri_v3 scaffold_3513, whole genome shotgun sequence",4903,0,0,0,0,0
"NW_020169285.1 Populus trichocarpa isolate Nisqually-1 unplaced genomic scaffold, Pop_tri_v3 scaffold_3523, whole genome shotgun sequence",1130,3,0,2,1,6
"NW_020169286.1 Populus trichocarpa isolate Nisqually-1 unplaced genomic scaffold, Pop_tri_v3 scaffold_3528, whole genome shotgun sequence",2635,0,0,0,1,1
"NW_020169287.1 Populus trichocarpa isolate Nisqually-1 unplaced genomic scaffold, Pop_tri_v3 scaffold_3537, whole genome shotgun sequence",1011,5,0,5,3,13
"NW_020169288.1 Populus trichocarpa isolate Nisqually-1 unplaced genomic scaffold, Pop_tri_v3 scaffold_3547, whole genome shotgun sequence",1702,0,0,0,1,1
"NW_020169289.1 Populus trichocarpa isolate Nisqually-1 unplaced genomic scaffold, Pop_tri_v3 scaffold_3549, whole genome shotgun sequence",8914,1,2,0,2,5
"NW_020169290.1 Populus trichocarpa isolate Nisqually-1 unplaced genomic scaffold, Pop_tri_v3 scaffold_3550, whole genome shotgun sequence",1938,0,1,1,1,3
"NW_020169291.1 Populus trichocarpa isolate Nisqually-1 unplaced genomic scaffold, Pop_tri_v3 scaffold_3584, whole genome shotgun sequence",3654,1,0,1,0,2
"NW_020169292.1 Populus trichocarpa isolate Nisqually-1 unplaced genomic scaffold, Pop_tri_v3 scaffold_3595, whole genome shotgun sequence",657,0,2,0,1,3
"NW_020169293.1 Populus trichocarpa isolate Nisqually-1 unplaced genomic scaffold, Pop_tri_v3 scaffold_3648, whole genome shotgun sequence",2796,0,2,2,0,4
"NW_020169294.1 Populus trichocarpa isolate Nisqually-1 unplaced genomic scaffold, Pop_tri_v3 scaffold_3664, whole genome shotgun sequence",3053,1,0,1,0,2
"NW_020169295.1 Populus trichocarpa isolate Nisqually-1 unplaced genomic scaffold, Pop_tri_v3 scaffold_3681, whole genome shotgun sequence",1022,1,1,1,1,4
"NC_009143.1 Populus trichocarpa chloroplast, complete genome",157033,1822,1140,1180,2022,6164
